🏔🏔🏔🏔🏔🏔🏔🏔🏔🏔🏔🏔🏔🏔🏔🏔🏔🏔🏔🏔🏔🏔🏔🏔🏔🏔🏔🏔🏔🏔🏔🏔🏔🏔🏔🏔🏔🏔🏔🏔🏔🏔🏔🏔🏔🏔🏔🏔🏔🏔🏔🏔🏔🏔🏔🏔🏔🏔🏔🏔🏔🏔🏔🏔🏔🏔🏔🏔🏔🏔🏔🏔🏔🏔🏔🏔🏔🏔🏔🏔🏔🏔🏔🏔🏔🏔🏔🏔🏔🏔🏔🏔🏔🏔🏔🏔🏔🏔🏔🏔
🏔🏔🏔🏔🏔🏔🏔🏔🏔🏔🏔🏔🏔🏔🏔🏔🏔🏔🏔🏔🏔🏔🏔🏔🏔🏔🏔🏔🏔🏔🏔🏔🏔🏔🏔🏔🏔🏔🏔🏔🏔🏔🏔🏔🏔🏔🏔🏔🏔🏔🏔🏔🏔🏔🏔🏔🏔🏔🏔🏔🏔🏔🏔🏔🏔🏔🏔🏔🏔🏔🏔🏔🏔🏔🏔🏔🏔🏔🏔🏔🏔🏔🏔🏔🏔🏔🏔🏔🏔🏔🏔🏔🏔🏔🏔🏔🏔🏔🏔🏔
🏔🏔🏔🏔🏔🏔🏔🏔🏔🏔🏔🏔🏔🏔🏔🏔🏔🏔🏔🏔🏔🏔🏔🏔🏔🏔🏔🏔🏔🏔🏔🏔🏔🏔🏔🏔🏔🏔🏔🏔🏔🏔🏔🏔🏔🏔🏔🏔🏔🏔🏔🏔🏔🏔🏔🏔🏔🏔🏔🏔🏔🏔🏔🏔🏔🏔🏔🏔🏔🏔🏔🏔🏔🏔🏔🏔🏔🏔🏔🏔🏔🏔🏔🏔🏔🏔🏔🏔🏔🏔🏔🌲🏔🏔🏔🏔🏔🏔🏔🏔
🏔🏔🏔🏔🏔🏔🏔🏔🏔🏔🏔🏔🏔🏔🏔🏔🏔🏔🏔🏔🏔🏔🏔🏔🏔🏔🏔🏔🏔🏔🏔🏔🏔🏔🏔🏔🏔🏔🏔🏔🏔🏔🏔🏔🏔🏔🏔🏔🏔🏔🏔🏔🏔🏔🏔🏔🏔🏔🏔🏔🏔🏔🏔🏔🏔🏔🏔🏔🏔🏔🏔🏔🏔🏔🏔🏔🏔🏔🏔🏔🏔🏔🏔🏔🏔🏔🏔🌲🌲🏔🏔🏔🏔🏔🏔🏔🏔🏔🏔🏔
🏔🏔🏔🏔🏔🏔🏔🏔🏔🏔🏔🏔🏔🏔🏔🏔🏔🏔🏔🏔🏔🏔🏔🏔🏔🏔🏔🏔🏔🏔🏔🏔🏔🏔🏔🏔🏔🏔🏔🏔🏔🏔🏔🏔🏔🏔🏔🏔🏔🏔🏔🏔🏔🏔🏔🏔🏔🏔🏔🏔🏔🏔🏔🏔🏔🏔🏔🏔🏔🏔🏔🏔🏔🏔🏔🏔🏔🏔🏔🏔🏔🏔🏔🏔🏔🏔🏔🏔🏔🏔🏔🏔🏔🏔🏔🏔🏔🏔🏔🏔
🏔🏔🏔🏔🏔🏔🏔🏔🏔🏔🏔🏔🏔🏔🏔🏔🏔🏔🏔🏔🏔🏔🏔🏔🏔🏔🏔🏔🏔🏔🏔🏔🏔🏔🏔🏔🏔🏔🏔🏔🏔🏔🏔🏔🏔🏔🏔🏔🏔🏔🏔🏔🏔🏔🏔🏔🏔🏔🏔🏔🏔🏔🏔🏔🏔🏔🏔🏔🏔🏔🏔🏔🏔🏔🏔🏔🏔🏔🏔🏔🏔🏔🏔🏔🏔🏔🏔🏔🏔🏔🏔🏔🏔🏔🏔🏔🏔🏔🏔🏔
🏔🏔🏔🏔🏔🏔🏔🏔🏔🏔🏔🏔🏔🏔🏔🏔🏔🏔🏔🏔🏔🏔🏔🏔🏔🏔🏔🏔🏔🏔🏔🏔🏔🏔🏔🏔🏔🏔🏔🏔🏔🏔🏔🏔🏔🏔🏔🏔🏔🏔🏔🏔🏔🏔🏔🏔🏔🏔🏔🏔🏔🏔🏔🏔🏔🏔🏔🏔🏔🏔🏔🏔🏔🏔🏔🏔🏔🏔🏔🏔🏔🏔🏔🏔🏔🏔🏔🏔🏔🏔🏔🏔🏔🏔🏔🏔🌲🏔🏔🏔
🏔🏔🏔🏔🏔🏔🏔🏔🏔🏔🏔🏔🏔🏔🏔🏔🏔🏔🏔🏔🏔🏔🏔🏔🏔🏔🏔🏔🏔🏔🏔🏔🏔🏔🏔🌲🏔🏔🏔🏔🏔🏔🏔🏔🏔🏔🏔🏔🏔🏔🏔🏔🏔🏔🏔🏔🏔🏔🏔🏔🏔🏔🏔🏔🏔🏔🏔🏔🏔🏔🏔🏔🏔🏔🏔🏔🏔🏔🏔🏔🏔🏔🏔🏔🏔🏔🏔🏔🏔🏔🏔🏔🏔🏔🏔🏔🌲🌲🏔🏔
🏔🏔🏔🏔🏔🏔🏔🏔🏔🏔🏔🏔🏔🏔🏔🏔🏔🏔🏔🏔🏔🏔🏔🏔🏔🏔🏔🏔🏔🏔🏔🏔🌲🌲🌲🌲🌲🌲🏔🏔🏔🏔🏔🏔🏔🏔🏔🏔🏔🏔🏔🏔🏔🏔🏔🏔🏔🏔🏔🏔🏔🏔🏔🏔🏔🏔🏔🏔🏔🏔🏔🏔🏔🏔🏔🏔🏔🏔🏔🏔🏔🏔🏔🏔🏔🏔🏔🏔🏔🏔🏔🏔🏔🏔🏔🏔🌲🌲🏔🏔
🏔🏔🏔🏔🏔🏔🏔🏔🏔🏔🏔🏔🏔🏔🏔🏔🏔🏔🏔🏔🏔🏔🏔🏔🏔🏔🏔🏔🏔🏔🌲🌲🌲🌲🌲🌲🌲🌲🌲🏔🏔🏔🏔🏔🏔🏔🏔🏔🏔🏔🏔🏔🏔🏔🏔🏔🏔🏔🏔🏔🏔🏔🏔🏔🏔🏔🏔🏔🏔🏔🏔🏔🏔🏔🏔🏔🏔🏔🏔🏔🏔🏔🏔🏔🏔🏔🏔🏔🏔🏔🏔🏔🏔🏔🏔🏔🏔🌲🏔🏔
🌲🏔🏔🏔🏔🏔🏔🏔🏔🏔🏔🏔🏔🏔🏔🏔🏔🏔🏔🏔🏔🏔🏔🏔🏔🏔🏔🏔🏔🌲🌲🌲🌲🌲🌲🌲🌲🌲🌲🏔🏔🏔🏔🏔🏔🏔🏔🏔🏔🏔🏔🏔🏔🏔🏔🏔🏔🏔🏔🏔🏔🏔🏔🏔🏔🏔🏔🏔🏔🏔🏔🏔🏔🏔🏔🏔🏔🏔🏔🏔🏔🏔🏔🏔🏔🏔🏔🏔🏔🏔🏔🏔🏔🏔🏔🏔🏔🏔🏔🏔
🏔🏔🏔🏔🏔🏔🏔🏔🏔🏔🏔🏔🏔🏔🏔🏔🏔🏔🏔🏔🏔🏔🏔🏔🏔🏔🏔🏔🌲🌲🌲🌲🌲🌲🌲🌲🌲🌲🌲🏔🏔🏔🏔🏔🏔🏔🏔🏔🏔🏔🏔🏔🏔🏔🏔🏔🏔🏔🏔🏔🏔🏔🏔🏔🏔🏔🏔🏔🏔🏔🌲🌲🌲🏔🏔🏔🏔🏔🏔🏔🏔🏔🏔🏔🏔🏔🏔🏔🏔🏔🏔🏔🏔🏔🏔🏔🏔🏔🏔🏔
🏔🏔🏔🏔🏔🏔🏔🏔🏔🏔🏔🏔🏔🏔🏔🏔🏔🏔🏔🏔🏔🏔🏔🏔🏔🏔🏔🏔🌲🌲🌲🌲🌲🌲🌲🌲🌲🌲🏔🏔🏔🏔🏔🏔🏔🏔🏔🏔🏔🏔🏔🏔🏔🏔🏔🏔🏔🏔🏔🏔🏔🏔🏔🏔🏔🏔🏔🏔🌲🌲🌲🌲🌲🌲🏔🏔🏔🏔🏔🏔🏔🏔🏔🏔🏔🏔🏔🏔🏔🏔🏔🏔🏔🏔🏔🏔🏔🏔🏔🏔
🏔🏔🏔🏔🏔🏔🏔🏔🏔🏔🏔🏔🏔🏔🏔🏔🏔🏔🏔🏔🏔🏔🏔🏔🏔🏔🏔🏔🌲🌲🌲🌲🌲🌲🌲🌲🌲🌲🏔🏔🏔🏔🏔🏔🏔🏔🏔🏔🏔🏔🏔🏔🏔🏔🏔🏔🏔🏔🏔🏔🏔🏔🏔🏔🏔🌲🌲🌲🌲🌲🌲🌲🌲🌲🌲🌲🏔🏔🏔🏔🏔🏔🏔🏔🏔🏔🏔🏔🏔🏔🏔🏔🏔🏔🏔🏔🏔🏔🏔🏔
🏔🏔🏔🏔🏔🏔🏔🏔🏔🏔🏔🏔🏔🏔🏔🏔🏔🏔🏔🏔🏔🏔🏔🏔🏔🏔🏔🏔🌲🌲🌲🌲🌲🌲🌲🌲🌲🌲🏔🏔🏔🏔🏔🏔🏔🏔🏔🏔🏔🏔🏔🏔🏔🏔🏔🏔🏔🏔🏔🏔🏔🏔🌲🌲🌲🌲🌲🌲🌲🌲🌲🌲🌲🌲🌲🌲🌲🏔🏔🏔🏔🏔🏔🏔🏔🏔🌲🌲🏔🏔🏔🏔🏔🏔🏔🏔🏔🏔🏔🏔
🏔🏔🏔🏔🏔🏔🏔🏔🏔🏔🏔🏔🏔🏔🏔🏔🏔🏔🏔🏔🏔🏔🏔🏔🏔🏔🏔🏔🌲🌲🌲🌲🌲🌲🌲🌲🏔🏔🏔🏔🏔🏔🏔🏔🏔🏔🏔🏔🏔🏔🏔🏔🏔🏔🏔🏔🏔🏔🏔🏔🌲🌲🌲🌲🌲🌲🌲🌲🌲🌲🌲🌲🌲🌲🌲🌲🌲🏔🏔🏔🏔🏔🏔🏔🏔🌲🌲🌲🌲🏔🏔🏔🏔🏔🏔🏔🏔🏔🏔🏔
🌲🏔🏔🏔🏔🏔🏔🏔🏔🏔🏔🏔🏔🏔🏔🏔🏔🏔🏔🏔🏔🏔🏔🏔🏔🏔🏔🌲🌲🌲🌲🌲🌲🌲🌲🏔🏔🏔🏔🏔🏔🏔🏔🏔🏔🏔🏔🏔🏔🏔🏔🏔🏔🏔🏔🏔🏔🏔🏔🌲🌲🌲🌲🌲🌲🌲🌲🌲🌲🌲🌲🌲🌲🌲🌲🌲🌲🏔🏔🏔🏔🏔🏔🏔🏔🌲🌲🌲🏔🏔🏔🏔🏔🏔🏔🏔🏔🏔🏔🏔
🌲🏔🏔🏔🏔🏔🏔🏔🏔🏔🏔🏔🏔🏔🏔🏔🏔🏔🏔🏔🏔🏔🏔🏔🏔🏔🏔🌲🌲🌲🌲🌲🌲🌲🏔🏔🏔🏔🏔🏔🏔🏔🏔🏔🏔🏔🏔🏔🏔🏔🏔🏔🏔🏔🏔🏔🏔🏔🏔🌲🌲🌲🌲🌲🌲🌲🌲🌲🌲🌲🌲🌲🌲🌲🌲🌲🌲🏔🏔🏔🏔🏔🏔🏔🏔🏔🏔🏔🏔🏔🏔🏔🏔🏔🏔🏔🏔🏔🏔🏔
🌲🌲🏔🏔🏔🏔🏔🏔🏔🏔🏔🏔🏔🏔🏔🏔🏔🏔🏔🏔🏔🏔🏔🏔🏔🏔🏔🌲🌲🌲🌲🌲🏔🏔🏔🏔🏔🏔🏔🏔🏔🏔🏔🏔🏔🏔🏔🏔🏔🏔🏔🏔🏔🏔🏔🏔🏔🏔🌲🌲🌲🌲🌲🌲🌲🌲🌲🌲🌲🌲🌲🌲🌲🌲🌲🌲🌲🏔🏔🏔🏔🏔🏔🏔🏔🏔🏔🏔🏔🏔🏔🏔🏔🏔🏔🏔🏔🏔🏔🏔
🌲🌲🏔🏔🏔🏔🏔🏔🏔🏔🏔🏔🏔🏔🏔🏔🏔🏔🏔🏔🏔🏔🏔🏔🏔🏔🏔🏔🏔🏔🏔🏔🏔🏔🏔🏔🏔🏔🏔🏔🏔🏔🏔🏔🏔🏔🏔🏔🏔🏔🏔🏔🏔🏔🏔🏔🏔🌲🌲🌲🌲🌲🌲🌲🌲🌲🌲🌲🌲🌲🌲🌲🌲🌲🌲🌲🌲🌲🏔🏔🏔🏔🏔🏔🏔🏔🏔🏔🏔🏔🏔🏔🏔🏔🏔🏔🏔🏔🏔🏔
🌲🏔🏔🏔🏔🏔🏔🏔🏔🏔🏔🏔🏔🏔🏔🏔🏔🏔🏔🏔🏔🏔🏔🏔🏔🏔🏔🏔🏔🏔🏔🏔🏔🏔🏔🏔🏔🏔🏔🏔🏔🏔🏔🏔🏔🏔🏔🏔🏔🏔🏔🏔🏔🏔🏔🏔🌲🌲🌲🌲🌲🌲🌲🌲🌲🌲🌲🌲🌲🌲🌲🌲🌲🌲🌲🌲🌲🏔🏔🏔🏔🏔🏔🏔🏔🏔🏔🏔🏔🏔🏔🏔🏔🏔🏔🏔🏔🏔🏔🏔
🌲🏔🏔🏔🏔🏔🏔🏔🏔🏔🏔🏔🏔🏔🏔🏔🏔🏔🏔🏔🏔🏔🏔🏔🏔🏔🏔🏔🏔🏔🏔🏔🏔🏔🏔🏔🏔🏔🏔🏔🏔🏔🏔🏔🏔🏔🏔🏔🏔🏔🏔🏔🏔🏔🏔🌲🌲🌲🌲🌲🌲🌲🌲🌲🌲🌲🌲🌲🌲🌲🌲🌲🌲🌲🌲🌲🌲🏔🏔🏔🏔🏔🏔🏔🏔🏔🏔🏔🏔🏔🏔🏔🏔🏔🏔🏔🏔🏔🏔🏔
🏔🏔🏔🏔🏔🏔🏔🏔🏔🏔🏔🏔🏔🏔🏔🏔🏔🏔🏔🏔🏔🏔🏔🏔🏔🏔🏔🏔🏔🏔🏔🏔🏔🏔🏔🏔🏔🏔🏔🏔🏔🏔🏔🏔🏔🏔🏔🏔🏔🏔🏔🏔🏔🏔🏔🌲🌲🌲🌲🌲🌲🌲🌲🌲🌲🌲🌲🌲🌲🌲🌲🌲🌲🌲🌲🌲🏔🏔🏔🏔🏔🏔🏔🏔🏔🏔🏔🏔🏔🏔🏔🏔🏔🏔🏔🏔🏔🏔🏔🏔
🏔🏔🏔🏔🏔🏔🏔🏔🏔🏔🏔🏔🏔🏔🏔🏔🏔🏔🏔🏔🏔🏔🏔🏔🏔🏔🏔🏔🏔🏔🏔🏔🏔🏔🏔🏔🏔🏔🏔🏔🏔🏔🏔🏔🏔🏔🏔🏔🏔🏔🏔🏔🏔🏔🏔🏔🌲🌲🌲🌲🌲🌲🌲🌲🌲🌲🌲🌲🌲🌲🌲🌲🌲🌲🌲🌲🏔🏔🏔🏔🏔🏔🏔🏔🏔🏔🏔🏔🏔🏔🏔🏔🏔🏔🏔🏔🏔🏔🏔🏔
🏔🏔🏔🏔🏔🏔🏔🏔🏔🏔🏔🏔🏔🏔🏔🏔🏔🏔🏔🏔🏔🏔🏔🏔🏔🏔🏔🏔🏔🏔🏔🏔🏔🏔🏔🏔🏔🏔🏔🏔🏔🏔🏔🏔🏔🏔🏔🏔🏔🏔🏔🏔🏔🏔🏔🏔🌲🌲🌲🌲🌲🌲🌲🌲🌲🌲🌲🌲🌲🌲🌲🌲🌲🌲🌲🏔🏔🏔🏔🏔🏔🏔🏔🏔🏔🏔🏔🏔🏔🏔🏔🏔🏔🏔🏔🏔🏔🏔🏔🏔
🏔🏔🏔🏔🏔🏔🏔🏔🏔🏔🏔🏔🏔🏔🏔🏔🏔🏔🏔🏔🏔🏔🏔🏔🏔🏔🏔🏔🏔🏔🏔🏔🏔🏔🏔🏔🏔🏔🏔🏔🏔🏔🏔🏔🏔🏔🏔🏔🏔🏔🏔🏔🏔🏔🏔🏔🌲🌲🌲🌲🌲🌲🌲🌲🌲🌲🌲🌲🌲🌲🌲🌲🌲🌲🌲🏔🏔🏔🏔🏔🏔🏔🏔🏔🏔🏔🏔🏔🏔🏔🏔🏔🏔🏔🏔🏔🏔🏔🏔🏔
🏔🏔🏔🏔🏔🏔🏔🏔🏔🏔🏔🏔🏔🏔🏔🏔🏔🏔🏔🏔🏔🏔🏔🏔🏔🏔🏔🏔🏔🏔🏔🏔🏔🏔🏔🏔🏔🏔🏔🏔🏔🏔🏔🏔🏔🏔🏔🏔🏔🏔🏔🏔🏔🏔🏔🏔🏔🌲🌲🌲🌲🌲🌲🌲🌲🌲🌲🌲🌲🌲🌲🌲🌲🌲🌲🏔🏔🏔🏔🏔🏔🏔🏔🏔🏔🏔🏔🏔🏔🏔🏔🏔🏔🏔🏔🏔🏔🏔🏔🏔
🏔🏔🏔🏔🏔🏔🏔🏔🏔🏔🏔🏔🏔🏔🏔🏔🏔🏔🏔🏔🏔🏔🏔🏔🏔🏔🏔🏔🏔🏔🏔🏔🏔🏔🏔🏔🏔🏔🏔🏔🏔🏔🏔🏔🏔🏔🏔🏔🏔🏔🏔🏔🏔🏔🏔🏔🏔🌲🌲🌲🌲🌲🌲🌲🌲🌲🌲🌲🌲🌲🌲🌲🌲🌲🏔🏔🏔🏔🏔🏔🏔🏔🏔🏔🏔🏔🏔🏔🏔🏔🏔🏔🏔🏔🏔🏔🏔🏔🏔🏔
🏔🏔🏔🏔🏔🏔🏔🏔🏔🏔🏔🏔🏔🏔🏔🏔🏔🏔🏔🏔🏔🏔🏔🏔🏔🏔🏔🏔🏔🏔🏔🏔🏔🏔🏔🏔🏔🏔🏔🏔🏔🏔🏔🏔🏔🏔🏔🏔🏔🏔🏔🏔🏔🏔🏔🏔🏔🌲🌲🌲🌲🌲🌲🌲🌲🌲🌲🌲🌲🌲🌲🌲🏔🏔🏔🏔🏔🏔🏔🏔🏔🏔🏔🏔🏔🏔🏔🏔🏔🏔🏔🏔🏔🏔🏔🏔🏔🏔🏔🏔
🏔🏔🏔🏔🏔🏔🏔🏔🏔🏔🏔🏔🏔🏔🏔🏔🏔🏔🏔🏔🏔🏔🏔🏔🏔🏔🏔🏔🏔🏔🏔🏔🏔🏔🏔🏔🏔🏔🏔🏔🏔🏔🏔🏔🏔🏔🏔🏔🏔🏔🏔🏔🏔🏔🏔🏔🏔🌲🌲🌲🌲🌲🌲🌲🌲🌲🌲🌲🌲🏔🏔🏔🏔🏔🏔🏔🏔🏔🏔🏔🏔🏔🏔🏔🏔🏔🏔🏔🏔🏔🏔🏔🏔🏔🏔🏔🏔🏔🏔🏔
🏔🏔🏔🏔🏔🏔🏔🏔🏔🏔🏔🏔🏔🏔🏔🏔🏔🏔🏔🏔🏔🏔🏔🏔🏔🏔🏔🏔🏔🏔🏔🏔🏔🏔🏔🏔🏔🏔🏔🏔🏔🏔🏔🏔🏔🏔🏔🏔🏔🏔🏔🏔🏔🏔🏔🏔🏔🌲🌲🌲🌲🌲🌲🌲🌲🌲🌲🌲🌲🏔🏔🏔🏔🏔🏔🏔🏔🏔🏔🏔🏔🏔🏔🏔🏔🏔🏔🏔🏔🏔🏔🏔🏔🏔🏔🏔🏔🏔🏔🏔
🏔🏔🏔🏔🏔🏔🏔🏔🏔🏔🏔🏔🏔🏔🏔🏔🏔🏔🏔🏔🏔🏔🏔🏔🏔🏔🏔🏔🏔🏔🏔🏔🏔🏔🏔🏔🏔🏔🏔🏔🏔🏔🏔🏔🏔🏔🏔🏔🏔🏔🏔🏔🏔🏔🏔🏔🏔🌲🌲🌲🌲🌲🌲🌲🌲🌲🌲🌲🏔🏔🏔🏔🏔🏔🏔🏔🏔🏔🏔🏔🏔🏔🏔🏔🏔🏔🏔🏔🏔🏔🏔🏔🏔🏔🏔🏔🏔🏔🏔🏔
🏔🏔🏔🏔🏔🏔🏔🏔🏔🏔🏔🏔🏔🏔🏔🏔🏔🏔🏔🏔🏔🏔🏔🏔🏔🏔🏔🏔🏔🏔🏔🏔🏔🏔🏔🏔🏔🏔🏔🏔🏔🏔🏔🏔🏔🏔🏔🏔🏔🏔🏔🏔🏔🏔🏔🏔🏔🌲🌲🌲🌲🌲🌲🌲🌲🌲🏔🏔🏔🏔🏔🏔🏔🏔🏔🏔🏔🏔🏔🏔🏔🏔🏔🏔🏔🏔🏔🏔🏔🏔🏔🏔🏔🏔🏔🏔🏔🏔🏔🏔
🏔🏔🏔🏔🏔🏔🏔🏔🏔🏔🏔🏔🏔🏔🏔🏔🏔🏔🏔🏔🏔🏔🏔🏔🏔🏔🏔🏔🏔🏔🏔🏔🏔🏔🏔🏔🏔🏔🏔🏔🏔🏔🏔🏔🏔🏔🏔🏔🏔🏔🏔🏔🏔🏔🏔🏔🏔🌲🌲🌲🌲🌲🌲🌲🏔🏔🏔🏔🏔🏔🏔🏔🏔🏔🏔🏔🏔🏔🏔🏔🏔🏔🏔🏔🏔🏔🏔🏔🏔🏔🏔🏔🏔🏔🏔🏔🏔🏔🏔🏔
🏔🏔🏔🏔🏔🏔🏔🏔🏔🏔🏔🏔🏔🏔🏔🏔🏔🏔🏔🏔🏔🏔🏔🏔🏔🏔🏔🏔🏔🏔🏔🏔🏔🏔🏔🏔🏔🏔🏔🏔🏔🏔🏔🏔🏔🏔🏔🏔🏔🏔🏔🏔🏔🏔🏔🏔🏔🏔🏔🌲🌲🌲🌲🏔🏔🏔🏔🏔🏔🏔🏔🏔🏔🏔🏔🏔🏔🏔🏔🏔🏔🏔🏔🏔🏔🏔🏔🏔🏔🏔🏔🏔🏔🏔🏔🏔🏔🏔🏔🏔
🏔🏔🏔🏔🏔🏔🏔🏔🏔🏔🏔🏔🏔🏔🏔🏔🏔🏔🏔🏔🏔🏔🏔🏔🏔🏔🏔🏔🏔🏔🏔🏔🏔🏔🏔🏔🏔🏔🏔🏔🏔🏔🏔🏔🏔🏔🏔🏔🏔🏔🏔🏔🏔🏔🏔🏔🏔🏔🏔🏔🏔🏔🏔🏔🏔🏔🏔🏔🏔🏔🏔🏔🏔🏔🏔🏔🏔🏔🏔🏔🏔🏔🏔🏔🏔🏔🏔🏔🏔🏔🏔🏔🏔🏔🏔🏔🏔🏔🏔🏔
🏔🏔🏔🏔🏔🏔🏔🏔🏔🏔🏔🏔🏔🏔🏔🏔🏔🏔🏔🏔🏔🏔🏔🏔🏔🏔🏔🏔🏔🏔🏔🏔🏔🏔🏔🏔🏔🏔🏔🏔🏔🏔🏔🏔🏔🏔🏔🏔🏔🏔🏔🏔🏔🏔🏔🏔🏔🏔🏔🏔🏔🏔🏔🏔🏔🏔🏔🏔🏔🏔🏔🏔🏔🏔🏔🏔🏔🏔🏔🏔🏔🏔🏔🏔🏔🏔🏔🏔🏔🏔🏔🏔🏔🏔🏔🏔🏔🏔🏔🏔
🏔🏔🏔🏔🏔🏔🏔🏔🏔🏔🏔🏔🏔🏔🏔🏔🏔🏔🏔🏔🏔🏔🏔🏔🏔🏔🏔🏔🏔🏔🏔🏔🏔🏔🏔🏔🏔🏔🏔🏔🏔🏔🏔🏔🏔🏔🏔🏔🏔🏔🏔🏔🏔🏔🏔🏔🏔🏔🏔🏔🏔🏔🏔🏔🏔🏔🏔🏔🏔🏔🏔🏔🏔🏔🏔🏔🏔🏔🏔🏔🏔🏔🏔🏔🏔🏔🏔🏔🏔🏔🏔🏔🏔🏔🏔🏔🏔🏔🏔🏔
🏔🏔🏔🏔🏔🏔🏔🏔🏔🏔🏔🏔🏔🏔🏔🏔🏔🏔🏔🏔🏔🏔🏔🏔🏔🏔🏔🏔🏔🏔🏔🏔🏔🏔🏔🏔🏔🏔🏔🏔🏔🏔🏔🏔🏔🏔🏔🏔🏔🏔🏔🏔🏔🏔🏔🏔🏔🏔🏔🏔🏔🏔🏔🏔🏔🏔🏔🏔🏔🏔🏔🏔🏔🏔🏔🏔🏔🏔🏔🏔🏔🏔🏔🏔🏔🏔🏔🏔🏔🏔🏔🏔🏔🏔🏔🏔🏔🏔🏔🏔
🏔🏔🏔🏔🏔🏔🏔🏔🏔🏔🏔🏔🏔🏔🏔🏔🏔🏔🏔🏔🏔🏔🏔🏔🏔🏔🏔🏔🏔🏔🏔🏔🏔🏔🏔🏔🏔🏔🏔🏔🏔🏔🏔🏔🏔🏔🏔🏔🏔🏔🏔🏔🏔🏔🏔🏔🏔🏔🏔🏔🏔🏔🏔🏔🏔🏔🏔🏔🏔🏔🏔🏔🏔🏔🏔🏔🏔🏔🏔🏔🏔🏔🏔🏔🏔🏔🏔🏔🏔🏔🏔🏔🏔🏔🏔🏔🏔🏔🏔🏔
🏔🏔🏔🏔🏔🏔🏔🏔🏔🏔🏔🏔🏔🏔🏔🏔🏔🏔🏔🏔🏔🏔🏔🏔🏔🏔🏔🏔🏔🏔🏔🏔🏔🏔🏔🏔🏔🏔🏔🏔🏔🏔🏔🏔🏔🏔🏔🏔🏔🏔🏔🏔🏔🏔🏔🏔🏔🏔🏔🏔🏔🏔🏔🏔🏔🏔🏔🏔🏔🏔🏔🏔🏔🏔🏔🏔🏔🏔🏔🏔🏔🏔🏔🏔🏔🏔🏔🏔🏔🏔🏔🏔🏔🏔🏔🏔🏔🏔🏔🏔
🏔🏔🏔🏔🏔🏔🏔🏔🏔🏔🏔🏔🏔🏔🏔🏔🏔🏔🏔🏔🏔🏔🏔🏔🏔🏔🏔🏔🏔🏔🏔🏔🏔🏔🏔🏔🏔🏔🏔🏔🏔🏔🏔🏔🏔🏔🏔🏔🏔🏔🏔🏔🏔🏔🏔🏔🏔🏔🏔🏔🏔🏔🏔🏔🏔🏔🏔🏔🏔🏔🏔🏔🏔🏔🏔🏔🏔🏔🏔🏔🏔🏔🏔🏔🏔🏔🏔🏔🏔🏔🏔🏔🏔🏔🏔🏔🏔🏔🏔🏔
🏔🏔🏔🏔🏔🏔🏔🏔🏔🏔🏔🏔🏔🏔🏔🏔🏔🏔🏔🏔🏔🏔🏔🏔🏔🏔🏔🏔🏔🏔🏔🏔🏔🏔🏔🏔🏔🏔🏔🏔🏔🏔🏔🏔🏔🏔🏔🏔🏔🏔🏔🏔🏔🏔🏔🏔🏔🏔🏔🏔🏔🏔🏔🏔🏔🏔🏔🏔🏔🏔🏔🏔🏔🏔🏔🏔🏔🏔🏔🏔🏔🏔🏔🏔🏔🏔🏔🏔🏔🏔🏔🏔🏔🏔🏔🏔🏔🏔🏔🏔
🏔🏔🏔🏔🏔🏔🏔🏔🏔🏔🏔🏔🏔🏔🏔🏔🏔🏔🏔🏔🏔🏔🏔🏔🏔🏔🏔🏔🏔🏔🏔🏔🏔🏔🏔🏔🏔🏔🏔🏔🏔🏔🏔🏔🏔🏔🏔🏔🏔🏔🏔🏔🏔🏔🏔🏔🏔🏔🏔🏔🏔🏔🏔🏔🏔🏔🏔🏔🏔🏔🏔🏔🏔🏔🏔🏔🏔🏔🏔🏔🏔🏔🏔🏔🏔🏔🏔🏔🏔🏔🏔🏔🏔🏔🏔🏔🏔🏔🏔🏔
🏔🏔🏔🏔🏔🏔🏔🏔🏔🏔🏔🏔🏔🏔🏔🏔🏔🏔🏔🏔🏔🏔🏔🏔🏔🏔🏔🏔🏔🏔🏔🏔🏔🏔🏔🏔🏔🏔🏔🏔🏔🏔🏔🏔🏔🏔🏔🏔🏔🏔🏔🏔🏔🏔🏔🏔🏔🏔🏔🏔🏔🏔🏔🏔🏔🏔🏔🏔🏔🏔🏔🏔🏔🏔🏔🏔🏔🏔🏔🏔🏔🏔🏔🏔🏔🏔🏔🏔🏔🏔🏔🏔🏔🏔🏔🏔🏔🏔🏔🏔
🏔🏔🏔🏔🏔🏔🏔🏔🏔🏔🏔🏔🏔🏔🏔🏔🌲🌲🌲🏔🏔🏔🏔🏔🏔🏔🏔🏔🏔🏔🏔🏔🏔🏔🏔🏔🏔🏔🏔🏔🏔🏔🏔🏔🏔🏔🏔🏔🏔🏔🏔🏔🏔🏔🏔🏔🏔🏔🏔🏔🏔🏔🏔🏔🏔🏔🏔🏔🏔🏔🏔🏔🏔🏔🏔🏔🏔🏔🏔🏔🏔🏔🏔🏔🏔🏔🏔🏔🏔🏔🏔🏔🏔🏔🏔🏔🏔🏔🏔🏔
🏔🏔🏔🏔🏔🏔🏔🏔🏔🏔🏔🏔🏔🏔🏔🌲🌲🌲🌲🌲🏔🏔🏔🏔🏔🏔🏔🏔🏔🏔🏔🏔🏔🏔🏔🏔🏔🏔🏔🏔🏔🏔🏔🏔🏔🏔🏔🏔🏔🏔🏔🏔🏔🏔🏔🏔🏔🏔🏔🏔🏔🏔🏔🏔🏔🏔🏔🏔🏔🏔🏔🏔🏔🏔🏔🏔🏔🏔🏔🏔🏔🏔🏔🏔🏔🏔🏔🏔🏔🏔🏔🏔🏔🏔🏔🏔🏔🏔🏔🏔
🏔🏔🏔🏔🏔🏔🏔🏔🏔🏔🏔🏔🏔🏔🏔🌲🌲🌲🌲🌲🌲🏔🏔🏔🏔🏔🏔🏔🏔🏔🏔🏔🏔🏔🏔🏔🏔🏔🏔🏔🏔🏔🏔🏔🏔🏔🏔🏔🏔🏔🏔🏔🏔🏔🏔🏔🏔🏔🏔🏔🏔🏔🏔🏔🏔🏔🏔🏔🏔🏔🏔🏔🏔🏔🏔🏔🏔🏔🏔🏔🏔🏔🏔🏔🏔🏔🏔🏔🏔🏔🏔🏔🏔🏔🏔🏔🏔🏔🏔🏔
🏔🏔🏔🏔🏔🏔🏔🏔🏔🏔🏔🏔🏔🏔🌲🌲🌲🌲🌲🌲🌲🌲🏔🏔🏔🏔🏔🏔🏔🏔🏔🏔🏔🏔🏔🏔🏔🏔🏔🏔🏔🏔🏔🏔🏔🏔🏔🏔🏔🏔🏔🏔🏔🏔🏔🏔🏔🏔🏔🏔🏔🏔🏔🏔🏔🏔🏔🏔🏔🏔🏔🏔🏔🏔🏔🏔🏔🏔🏔🏔🏔🏔🏔🏔🏔🏔🏔🏔🏔🏔🏔🏔🏔🏔🏔🏔🏔🏔🏔🏔
🏔🏔🏔🏔🏔🏔🏔🏔🏔🏔🏔🏔🏔🏔🌲🌲🌲🌲🌲🌲🌲🌲🏔🏔🏔🏔🏔🏔🏔🏔🏔🏔🏔🏔🏔🏔🏔🏔🏔🏔🏔🏔🏔🏔🏔🏔🏔🏔🏔🏔🏔🏔🏔🏔🏔🏔🏔🏔🏔🏔🏔🏔🏔🏔🏔🏔🏔🏔🏔🏔🏔🏔🏔🏔🏔🏔🏔🏔🏔🏔🏔🏔🏔🏔🏔🏔🏔🏔🏔🏔🏔🏔🏔🏔🏔🏔🏔🏔🏔🏔
🏔🏔🏔🏔🏔🏔🏔🏔🏔🏔🏔🏔🏔🏔🌲🌲🌲🌲🌲🌲🌲🌲🏔🏔🏔🏔🏔🏔🏔🏔🏔🏔🏔🏔🏔🏔🏔🏔🏔🏔🏔🏔🏔🏔🏔🏔🏔🏔🏔🏔🏔🏔🏔🏔🏔🏔🏔🏔🏔🏔🏔🏔🏔🏔🏔🏔🏔🏔🏔🏔🏔🏔🏔🏔🏔🏔🏔🏔🏔🏔🏔🏔🏔🏔🏔🏔🏔🏔🏔🏔🏔🏔🏔🏔🏔🏔🏔🏔🏔🏔
🏔🏔🏔🏔🏔🏔🏔🏔🏔🏔🏔🏔🏔🏔🌲🌲🌲🌲🌲🌲🌲🌲🌲🏔🏔🏔🏔🏔🏔🏔🏔🏔🏔🏔🏔🏔🏔🏔🏔🏔🏔🏔🏔🏔🏔🏔🏔🏔🏔🏔🏔🏔🏔🏔🏔🏔🏔🏔🏔🏔🏔🏔🏔🏔🏔🏔🏔🏔🏔🏔🏔🏔🏔🏔🏔🏔🏔🏔🏔🏔🏔🏔🏔🏔🏔🏔🏔🏔🏔🏔🏔🏔🏔🏔🏔🏔🏔🏔🏔🏔
🏔🏔🏔🏔🏔🏔🏔🏔🏔🏔🏔🏔🏔🏔🌲🌲🌲🌲🌲🌲🌲🌲🌲🌲🌲🏔🏔🏔🏔🏔🏔🏔🏔🏔🏔🏔🏔🏔🏔🏔🏔🏔🏔🏔🏔🏔🏔🏔🏔🏔🏔🏔🏔🏔🏔🏔🏔🏔🏔🏔🏔🏔🏔🏔🏔🏔🏔🏔🏔🏔🏔🏔🏔🏔🏔🏔🏔🏔🏔🏔🏔🏔🏔🏔🏔🏔🏔🏔🏔🏔🏔🏔🏔🏔🏔🏔🏔🏔🏔🏔
🏔🏔🏔🏔🏔🏔🏔🏔🏔🏔🏔🏔🏔🏔🌲🌲🌲🌲🌲🌲🌲🌲🌲🌲🌲🏔🏔🏔🏔🏔🏔🏔🏔🏔🏔🏔🏔🏔🏔🏔🏔🏔🏔🏔🏔🏔🏔🏔🏔🏔🏔🏔🏔🏔🏔🏔🏔🏔🏔🏔🏔🏔🏔🏔🏔🏔🏔🏔🏔🏔🏔🏔🏔🏔🏔🏔🏔🏔🏔🏔🏔🏔🏔🏔🏔🏔🏔🏔🏔🏔🏔🏔🏔🏔🏔🏔🏔🏔🏔🏔
🏔🏔🏔🏔🏔🏔🏔🏔🏔🏔🏔🏔🏔🌲🌲🌲🌲🌲🌲🌲🌲🌲🌲🌲🌲🏔🏔🏔🏔🏔🏔🏔🏔🏔🏔🏔🏔🏔🏔🏔🏔🏔🏔🏔🏔🏔🏔🏔🏔🏔🏔🏔🏔🏔🏔🏔🏔🌲🌲🏔🏔🏔🏔🏔🏔🏔🏔🏔🏔🏔🏔🏔🏔🏔🏔🏔🏔🏔🏔🏔🏔🏔🏔🏔🏔🏔🏔🏔🏔🏔🏔🏔🏔🏔🏔🏔🏔🏔🏔🏔
🏔🏔🏔🏔🏔🏔🏔🏔🏔🏔🏔🏔🌲🌲🌲🌲🌲🌲🌲🌲🌲🌲🌲🌲🌲🏔🏔🏔🏔🏔🏔🏔🏔🏔🏔🏔🏔🏔🏔🏔🏔🏔🏔🏔🏔🏔🏔🏔🏔🏔🌲🌲🌲🌲🌲🌲🌲🌲🌲🌲🏔🏔🏔🏔🏔🏔🏔🏔🏔🏔🏔🏔🏔🏔🏔🏔🏔🏔🏔🏔🏔🏔🏔🏔🏔🏔🏔🏔🏔🏔🏔🏔🏔🏔🏔🏔🏔🏔🏔🏔
🏔🏔🏔🏔🏔🏔🏔🏔🏔🏔🏔🏔🏔🏔🏔🌲🌲🌲🌲🌲🌲🌲🌲🌲🌲🏔🏔🏔🏔🏔🏔🏔🏔🏔🏔🏔🏔🏔🏔🏔🏔🏔🏔🏔🏔🏔🏔🏔🌲🌲🌲🌲🌲🌲🌲🌲🌲🌲🌲🌲🌲🏔🏔🏔🏔🏔🏔🏔🏔🏔🏔🏔🏔🏔🏔🏔🏔🏔🏔🏔🏔🏔🏔🏔🏔🏔🏔🏔🏔🏔🏔🏔🏔🏔🏔🏔🏔🏔🏔🏔
🏔🏔🏔🏔🏔🏔🏔🏔🏔🏔🏔🏔🏔🏔🏔🏔🌲🌲🌲🌲🌲🌲🌲🌲🌲🌲🏔🏔🏔🏔🏔🏔🏔🏔🏔🏔🏔🏔🏔🏔🏔🏔🏔🏔🌲🌲🌲🌲🌲🌲🌲🌲🌲🌲🌲🌲🌲🌲🌲🌲🌲🌲🏔🏔🏔🏔🏔🏔🏔🏔🏔🏔🏔🏔🏔🏔🏔🏔🏔🏔🏔🏔🏔🏔🏔🏔🏔🏔🏔🏔🏔🏔🏔🏔🏔🏔🏔🏔🏔🏔
🏔🏔🏔🏔🏔🏔🏔🏔🏔🏔🏔🏔🏔🏔🏔🏔🏔🌲🌲🌲🌲🌲🌲🌲🌲🌲🏔🏔🏔🏔🏔🏔🏔🏔🏔🏔🏔🏔🏔🏔🏔🏔🌲🌲🌲🌲🌲🌲🌲🌲🌲🌲🌲🌲🌲🌲🌲🌲🌲🌲🌲🌲🏔🏔🏔🏔🏔🏔🏔🏔🏔🏔🏔🏔🏔🏔🏔🏔🏔🏔🏔🏔🏔🏔🏔🏔🏔🏔🏔🏔🏔🏔🏔🏔🏔🏔🏔🏔🏔🏔
🏔🏔🏔🏔🏔🏔🏔🏔🌲🌲🌲🏔🏔🏔🏔🏔🏔🌲🌲🌲🌲🌲🌲🌲🌲🌲🏔🏔🏔🏔🏔🏔🏔🏔🏔🏔🏔🏔🌲🌲🌲🌲🌲🌲🌲🌲🌲🌲🌲🌲🌲🌲🌲🌲🌲🌲🌲🌲🌲🌲🌲🌲🌲🏔🏔🏔🏔🏔🏔🏔🏔🏔🏔🏔🏔🏔🏔🏔🏔🏔🏔🏔🏔🏔🏔🏔🏔🏔🏔🏔🏔🏔🏔🏔🏔🏔🏔🏔🏔🏔
🏔🏔🏔🏔🏔🏔🏔🏔🏔🌲🌲🏔🏔🏔🏔🏔🏔🏔🏔🏔🏔🌲🌲🌲🌲🌲🏔🏔🏔🏔🏔🏔🏔🏔🏔🏔🏔🌲🌲🌲🌲🌲🌲🌲🌲🌲🌲🌲🌲🌲🌲🌲🌲🌲🌲🌲🌲🌲🌲🌲🌲🌲🏔🏔🏔🏔🏔🏔🏔🏔🏔🏔🏔🏔🏔🏔🏔🏔🏔🏔🏔🏔🏔🏔🏔🏔🏔🏔🏔🏔🏔🏔🏔🏔🏔🏔🏔🏔🏔🏔
🏔🏔🏔🏔🏔🏔🏔🏔🏔🏔🏔🏔🏔🏔🏔🏔🏔🏔🏔🏔🏔🏔🌲🌲🌲🏔🏔🏔🏔🏔🏔🏔🏔🏔🏔🏔🏔🌲🌲🌲🌲🌲🌲🌲🌲🌲🌲🌲🌲🌲🌲🌲🌲🌲🌲🌲🌲🌲🌲🌲🌲🌲🏔🏔🏔🏔🏔🏔🏔🏔🏔🏔🏔🏔🏔🏔🏔🏔🏔🏔🏔🏔🏔🏔🏔🏔🏔🏔🏔🏔🏔🏔🏔🏔🏔🏔🏔🏔🏔🏔
🏔🏔🏔🏔🏔🏔🏔🏔🏔🏔🏔🏔🏔🏔🏔🏔🏔🏔🏔🏔🏔🏔🏔🌲🏔🏔🏔🏔🏔🏔🏔🏔🏔🏔🏔🏔🏔🌲🌲🌲🌲🌲🌲🌲🌲🌲🌲🌲🌲🌲🌲🌲🌲🌲🌲🌲🌲🌲🌲🌲🌲🏔🏔🏔🏔🏔🏔🏔🏔🏔🏔🏔🏔🏔🏔🏔🏔🏔🏔🏔🏔🏔🏔🏔🏔🏔🏔🏔🏔🏔🏔🏔🏔🏔🏔🏔🏔🏔🏔🏔
🏔🏔🏔🏔🏔🏔🏔🏔🏔🏔🏔🏔🏔🏔🏔🏔🏔🏔🏔🏔🏔🏔🏔🏔🏔🏔🏔🏔🏔🏔🏔🏔🏔🏔🏔🏔🏔🌲🌲🌲🌲🌲🌲🌲🌲🌲🌲🌲🌲🌲🌲🌲🌲🌲🌲🌲🌲🌲🌲🌲🌲🏔🏔🏔🏔🏔🏔🏔🏔🏔🏔🏔🏔🏔🏔🏔🏔🏔🏔🏔🏔🏔🏔🏔🏔🏔🏔🏔🏔🏔🏔🏔🏔🏔🏔🏔🏔🏔🏔🏔
🏔🏔🏔🏔🏔🏔🏔🏔🏔🏔🏔🏔🏔🏔🏔🏔🏔🏔🏔🏔🏔🏔🏔🏔🏔🏔🏔🏔🏔🏔🏔🏔🏔🏔🏔🏔🌲🌲🌲🌲🌲🌲🌲🌲🌲🌲🌲🌲🌲🌲🌲🌲🌲🌲🌲🌲🌲🌲🌲🌲🏔🏔🏔🏔🏔🏔🏔🏔🏔🏔🏔🏔🏔🏔🏔🏔🏔🏔🏔🏔🏔🏔🏔🏔🏔🏔🏔🏔🏔🏔🏔🏔🏔🏔🏔🏔🏔🏔🏔🏔
🏔🏔🏔🏔🏔🏔🏔🏔🏔🏔🏔🏔🏔🏔🏔🏔🏔🏔🏔🏔🏔🏔🏔🏔🏔🏔🏔🏔🏔🏔🏔🏔🏔🏔🏔🏔🌲🌲🌲🌲🌲🌲🌲🌲🌲🌲🌲🌲🌲🌲🌲🌲🌲🌲🌲🌲🌲🌲🌲🏔🏔🏔🏔🏔🏔🏔🏔🏔🏔🏔🏔🏔🏔🏔🏔🏔🏔🏔🏔🏔🏔🏔🏔🏔🏔🏔🏔🏔🏔🏔🏔🏔🏔🏔🏔🏔🏔🏔🏔🏔
🏔🏔🏔🏔🏔🏔🏔🏔🏔🏔🏔🏔🏔🏔🏔🏔🏔🏔🏔🏔🏔🏔🏔🏔🏔🏔🏔🏔🏔🏔🏔🏔🏔🏔🏔🌲🌲🌲🌲🌲🌲🌲🌲🌲🌲🌲🌲🌲🌲🌲🌲🌲🌲🌲🌲🌲🌲🌲🏔🏔🏔🏔🏔🏔🏔🏔🏔🏔🏔🏔🏔🏔🏔🏔🏔🏔🏔🏔🏔🏔🏔🏔🏔🏔🏔🏔🏔🏔🏔🏔🏔🏔🏔🏔🏔🏔🏔🏔🏔🏔
🏔🏔🏔🏔🏔🏔🏔🏔🏔🏔🏔🏔🏔🏔🏔🏔🏔🏔🏔🏔🏔🏔🏔🏔🏔🏔🏔🏔🏔🏔🏔🏔🏔🏔🏔🌲🌲🌲🌲🌲🌲🌲🌲🌲🌲🌲🌲🌲🌲🌲🌲🌲🌲🌲🌲🌲🏔🏔🏔🏔🏔🏔🏔🏔🏔🏔🏔🏔🏔🏔🏔🏔🏔🏔🏔🏔🏔🏔🏔🏔🏔🏔🏔🏔🏔🏔🏔🏔🏔🏔🏔🏔🏔🏔🏔🏔🏔🏔🏔🏔
🏔🏔🏔🏔🏔🏔🏔🏔🏔🏔🏔🏔🏔🏔🏔🏔🏔🏔🏔🏔🏔🏔🏔🏔🏔🏔🏔🏔🏔🏔🏔🏔🏔🏔🌲🌲🌲🌲🌲🌲🌲🌲🌲🌲🌲🌲🌲🌲🌲🌲🌲🌲🌲🌲🏔🏔🏔🏔🏔🏔🏔🏔🏔🏔🏔🏔🏔🏔🏔🏔🏔🏔🏔🏔🏔🏔🏔🏔🏔🏔🏔🏔🏔🏔🏔🏔🏔🏔🏔🏔🏔🏔🏔🏔🏔🏔🏔🏔🏔🏔
🏔🏔🏔🏔🏔🏔🏔🏔🏔🏔🏔🏔🏔🏔🏔🏔🏔🏔🏔🏔🏔🏔🏔🏔🏔🏔🏔🏔🏔🏔🏔🏔🏔🌲🌲🌲🌲🌲🌲🌲🌲🌲🌲🌲🌲🌲🌲🌲🌲🌲🌲🌲🌲🌲🏔🏔🏔🏔🏔🏔🏔🏔🏔🏔🏔🏔🏔🏔🏔🏔🏔🏔🏔🏔🏔🏔🏔🏔🏔🏔🏔🏔🏔🏔🏔🏔🏔🏔🏔🏔🏔🏔🏔🏔🏔🏔🏔🏔🏔🏔
🏔🏔🏔🏔🏔🏔🏔🏔🏔🏔🏔🏔🏔🏔🏔🏔🏔🏔🏔🏔🏔🏔🏔🌲🌲🌲🌲🌲🌲🌲🌲🌲🌲🌲🌲🌲🌲🌲🌲🌲🌲🌲🌲🌲🌲🌲🌲🌲🌲🌲🌲🌲🌲🌲🏔🏔🏔🏔🏔🏔🏔🏔🏔🏔🏔🏔🏔🏔🏔🏔🏔🏔🏔🏔🏔🏔🏔🏔🏔🏔🏔🏔🏔🏔🏔🏔🏔🏔🏔🏔🏔🏔🏔🏔🏔🏔🏔🏔🏔🏔
🏔🏔🏔🏔🏔🏔🏔🏔🏔🏔🏔🏔🏔🏔🏔🏔🏔🏔🏔🏔🏔🏔🏔🌲🌲🌲🌲🌲🌲🌲🌲🌲🌲🌲🌲🌲🌲🌲🌲🌲🌲🌲🌲🌲🌲🌲🌲🌲🌲🌲🌲🌲🌲🌲🏔🏔🏔🏔🏔🏔🏔🏔🏔🏔🏔🏔🏔🏔🏔🏔🏔🏔🏔🏔🏔🏔🏔🏔🏔🏔🏔🏔🏔🏔🏔🏔🏔🏔🏔🏔🏔🏔🏔🏔🏔🏔🏔🏔🏔🏔
🏔🏔🏔🏔🏔🏔🏔🏔🏔🏔🏔🏔🏔🏔🏔🏔🏔🏔🏔🏔🏔🏔🏔🏔🌲🌲🌲🌲🌲🌲🌲🌲🌲🌲🌲🌲🌲🌲🌲🌲🌲🌲🌲🌲🌲🌲🌲🌲🌲🌲🌲🌲🌲🏔🏔🏔🏔🏔🏔🏔🏔🏔🏔🏔🏔🏔🏔🏔🏔🏔🏔🏔🏔🏔🏔🏔🏔🏔🏔🏔🏔🏔🏔🏔🏔🏔🏔🏔🏔🏔🏔🏔🏔🏔🏔🏔🏔🏔🏔🏔
🏔🏔🏔🏔🏔🏔🏔🏔🏔🏔🏔🏔🏔🏔🏔🏔🏔🏔🏔🏔🏔🏔🏔🏔🌲🌲🌲🌲🌲🌲🌲🌲🌲🌲🌲🌲🌲🌲🌲🌲🌲🌲🌲🌲🌲🌲🌲🌲🌲🌲🌲🌲🌲🏔🏔🏔🏔🏔🏔🏔🏔🏔🏔🏔🏔🏔🏔🏔🏔🏔🏔🏔🏔🏔🏔🏔🏔🏔🏔🏔🏔🏔🏔🏔🏔🏔🏔🏔🏔🏔🏔🏔🏔🏔🏔🏔🏔🏔🏔🏔
🏔🏔🏔🏔🏔🏔🏔🏔🏔🏔🏔🏔🏔🏔🏔🏔🌲🌲🏔🏔🏔🏔🏔🏔🌲🌲🌲🌲🌲🌲🌲🌲🌲🌲🌲🌲🌲🌲🌲🌲🌲🌲🌲🌲🌲🌲🌲🌲🌲🌲🌲🌲🏔🏔🏔🏔🏔🏔🏔🏔🏔🏔🏔🏔🏔🏔🏔🏔🏔🏔🏔🏔🏔🏔🏔🏔🏔🏔🏔🏔🏔🏔🏔🏔🏔🏔🏔🏔🏔🏔🏔🏔🏔🏔🏔🏔🏔🏔🏔🏔
🏔🏔🏔🏔🏔🏔🏔🏔🏔🏔🏔🏔🏔🏔🏔🌲🌲🌲🌲🌲🏔🏔🏔🏔🌲🌲🌲🌲🌲🌲🌲🌲🌲🌲🌲🌲🌲🌲🌲🌲🌲🌲🌲🌲🌲🌲🌲🌲🌲🌲🌲🌲🏔🏔🏔🏔🏔🏔🏔🏔🏔🏔🏔🏔🏔🏔🏔🏔🏔🏔🏔🏔🏔🏔🏔🏔🏔🏔🏔🏔🏔🏔🏔🏔🏔🏔🏔🏔🏔🏔🏔🏔🏔🏔🏔🏔🏔🏔🏔🏔
🏔🏔🏔🏔🏔🏔🏔🏔🏔🏔🏔🏔🏔🏔🏔🌲🌲🌲🌲🌲🏔🏔🏔🌲🌲🌲🌲🌲🌲🌲🌲🌲🌲🌲🌲🌲🌲🌲🌲🌲🌲🌲🌲🌲🌲🌲🌲🌲🌲🌲🌲🌲🏔🏔🏔🏔🏔🏔🏔🏔🏔🏔🏔🏔🏔🏔🏔🏔🏔🏔🏔🏔🏔🏔🏔🏔🏔🏔🏔🏔🏔🏔🏔🏔🏔🏔🏔🏔🏔🏔🏔🏔🏔🏔🏔🏔🏔🏔🏔🏔
🏔🏔🏔🏔🏔🏔🏔🏔🏔🏔🏔🏔🏔🏔🌲🌲🌲🌲🌲🌲🌲🌲🌲🌲🌲🌲🌲🌲🌲🌲🌲🌲🌲🌲🌲🌲🌲🌲🌲🌲🌲🌲🌲🌲🌲🌲🌲🌲🌲🌲🌲🏔🏔🏔🏔🏔🏔🏔🏔🏔🏔🏔🏔🏔🏔🏔🏔🏔🏔🏔🏔🏔🏔🏔🏔🏔🏔🏔🏔🏔🏔🏔🏔🏔🏔🏔🏔🏔🏔🏔🏔🏔🏔🏔🏔🏔🏔🏔🏔🏔
🏔🏔🏔🏔🏔🏔🏔🏔🏔🏔🏔🏔🏔🏔🌲🌲🌲🌲🌲🌲🌲🌲🌲🌲🌲🌲🌲🌲🌲🌲🌲🌲🌲🌲🌲🌲🌲🌲🌲🌲🌲🌲🌲🌲🌲🌲🌲🌲🌲🌲🌲🏔🏔🏔🏔🏔🏔🏔🏔🏔🏔🏔🏔🏔🏔🏔🏔🏔🏔🏔🏔🏔🏔🏔🏔🏔🏔🏔🏔🏔🏔🏔🏔🏔🏔🏔🏔🏔🏔🏔🏔🏔🏔🏔🏔🏔🏔🏔🏔🏔
🏔🏔🏔🏔🏔🏔🏔🏔🏔🏔🏔🏔🏔🌲🌲🌲🌲🌲🌲🌲🌲🌲🌲🌲🌲🌲🌲🌲🌲🌲🌲🌲🌲🌲🌲🌲🌲🌲🌲🌲🌲🌲🌲🌲🌲🌲🌲🌲🌲🌲🌲🏔🏔🏔🏔🏔🏔🏔🏔🏔🏔🏔🏔🏔🏔🏔🏔🏔🏔🏔🏔🏔🏔🏔🏔🏔🏔🏔🏔🏔🏔🏔🏔🏔🏔🏔🏔🏔🏔🏔🏔🏔🏔🏔🏔🏔🏔🏔🏔🏔
🏔🏔🏔🏔🏔🏔🏔🏔🏔🏔🏔🏔🏔🏔🌲🌲🌲🌲🌲🌲🌲🌲🌲🌲🌲🌲🌲🌲🌲🌲🌲🌲🌲🌲🌲🌲🌲🌲🌲🌲🌲🌲🌲🌲🌲🌲🌲🌲🌲🌲🌲🏔🏔🏔🏔🏔🏔🏔🏔🏔🏔🏔🏔🏔🏔🏔🏔🏔🏔🏔🏔🏔🏔🏔🏔🏔🏔🏔🏔🏔🏔🏔🏔🏔🏔🏔🏔🏔🏔🏔🏔🏔🏔🏔🏔🏔🏔🏔🏔🏔
🏔🏔🏔🏔🏔🏔🏔🏔🏔🏔🏔🏔🏔🏔🏔🌲🌲🌲🌲🌲🌲🌲🌲🌲🌲🌲🌲🌲🌲🌲🌲🌲🌲🌲🌲🌲🌲🌲🌲🌲🌲🌲🌲🌲🌲🌲🌲🌲🌲🌲🌲🌲🏔🏔🏔🏔🏔🏔🏔🏔🏔🏔🏔🏔🏔🏔🏔🏔🏔🏔🏔🏔🏔🏔🏔🏔🏔🏔🏔🏔🏔🏔🏔🏔🏔🏔🏔🏔🏔🏔🏔🏔🏔🏔🏔🏔🏔🏔🏔🏔
🏔🏔🏔🏔🏔🏔🏔🏔🏔🏔🏔🏔🏔🏔🏔🏔🌲🌲🌲🌲🌲🌲🌲🌲🌲🌲🌲🌲🌲🌲🌲🌲🌲🌲🌲🌲🌲🌲🌲🌲🌲🌲🌲🌲🌲🌲🌲🌲🌲🌲🌲🌲🏔🏔🏔🏔🏔🏔🏔🏔🏔🏔🏔🏔🏔🏔🏔🏔🏔🏔🏔🏔🏔🏔🏔🏔🏔🏔🏔🏔🏔🏔🏔🏔🏔🏔🏔🏔🏔🏔🏔🏔🏔🏔🏔🏔🏔🏔🏔🏔
🏔🏔🏔🏔🏔🏔🏔🏔🏔🏔🏔🏔🏔🏔🏔🏔🏔🌲🌲🌲🌲🌲🌲🌲🌲🌲🌲🌲🌲🌲🌲🌲🌲🌲🌲🌲🌲🌲🌲🌲🌲🌲🌲🌲🌲🌲🌲🌲🌲🌲🌲🌲🌲🏔🏔🏔🏔🏔🏔🏔🏔🏔🏔🏔🏔🏔🏔🏔🏔🏔🏔🏔🏔🏔🏔🏔🏔🏔🏔🏔🏔🏔🏔🏔🏔🏔🏔🏔🏔🏔🏔🏔🏔🏔🏔🏔🏔🏔🏔🏔
🏔🏔🏔🏔🏔🏔🏔🏔🏔🏔🏔🏔🏔🏔🏔🏔🏔🏔🌲🌲🌲🌲🌲🌲🌲🌲🌲🌲🌲🌲🌲🌲🌲🌲🌲🌲🌲🌲🌲🌲🌲🌲🌲🌲🌲🌲🌲🌲🌲🌲🌲🌲🌲🏔🏔🏔🏔🏔🏔🏔🏔🏔🏔🏔🏔🏔🏔🏔🏔🏔🏔🏔🏔🏔🏔🏔🏔🏔🏔🏔🏔🏔🏔🏔🏔🏔🏔🏔🏔🏔🏔🏔🏔🏔🏔🏔🏔🏔🏔🏔
🏔🏔🏔🏔🏔🏔🏔🏔🏔🏔🏔🏔🏔🏔🏔🏔🏔🌲🌲🌲🌲🌲🌲🌲🌲🌲🌲🌲🌲🌲🌲🌲🌲🌲🌲🌲🌲🌲🌲🌲🌲🌲🌲🌲🌲🌲🌲🌲🌲🌲🌲🌲🌲🌲🏔🏔🏔🏔🏔🏔🏔🏔🏔🏔🏔🏔🏔🏔🏔🏔🏔🏔🏔🏔🏔🏔🏔🏔🏔🏔🏔🏔🏔🏔🏔🏔🏔🏔🏔🏔🏔🏔🏔🏔🏔🏔🏔🏔🏔🏔
🏔🏔🏔🏔🏔🏔🏔🏔🏔🏔🏔🏔🏔🏔🏔🏔🌲🌲🌲🌲🌲🌲🌲🌲🌲🌲🌲🌲🌲🌲🌲🌲🌲🌲🌲🌲🌲🌲🌲🌲🌲🌲🌲🌲🌲🌲🌲🌲🌲🌲🌲🌲🌲🌲🏔🏔🏔🏔🏔🏔🏔🏔🏔🏔🏔🏔🏔🏔🏔🏔🏔🏔🏔🏔🏔🏔🏔🏔🏔🏔🏔🏔🏔🏔🏔🏔🏔🏔🏔🏔🏔🏔🏔🏔🏔🏔🏔🏔🏔🏔
🏔🏔🏔🏔🏔🏔🏔🏔🏔🏔🏔🏔🏔🏔🏔🏔🌲🌲🌲🌲🌲🌲🌲🌲🌲🌲🌲🌲🌲🌲🌲🌲🌲🌲🌲🌲🌲🌲🌲🌲🌲🌲🌲🌲🌲🌲🌲🌲🌲🌲🌲🌲🌲🏔🏔🏔🏔🏔🏔🏔🏔🏔🏔🏔🏔🏔🏔🏔🏔🏔🏔🏔🏔🏔🏔🏔🏔🏔🏔🏔🏔🏔🏔🏔🏔🏔🏔🏔🏔🏔🏔🏔🏔🏔🏔🏔🏔🏔🏔🏔
🏔🏔🏔🏔🏔🏔🏔🏔🏔🏔🏔🏔🏔🏔🏔🏔🌲🌲🌲🌲🌲🌲🌲🌲🌲🌲🌲🌲🌲🌲🌲🌲🌲🌲🌲🌲🌲🌲🌲🌲🌲🌲🌲🌲🌲🌲🌲🌲🌲🌲🌲🌲🌲🏔🏔🏔🏔🏔🏔🏔🏔🏔🏔🏔🏔🏔🏔🏔🏔🏔🏔🏔🏔🏔🏔🏔🏔🏔🏔🏔🏔🏔🏔🏔🏔🏔🏔🏔🏔🏔🏔🏔🏔🏔🏔🏔🏔🏔🏔🏔
🏔🏔🏔🏔🏔🏔🏔🏔🏔🏔🏔🏔🏔🏔🏔🏔🌲🌲🌲🌲🌲🌲🌲🌲🌲🌲🌲🌲🌲🌲🌲🌲🌲🌲🌲🌲🌲🌲🌲🌲🌲🌲🌲🌲🌲🌲🌲🌲🌲🌲🌲🌲🏔🏔🏔🏔🏔🏔🏔🏔🏔🏔🏔🏔🏔🏔🏔🏔🏔🏔🏔🏔🏔🏔🏔🏔🏔🏔🏔🏔🏔🏔🏔🏔🏔🏔🏔🏔🏔🏔🏔🏔🏔🏔🏔🏔🏔🏔🏔🏔
🏔🏔🏔🏔🏔🏔🏔🏔🏔🏔🏔🏔🏔🏔🏔🏔🏔🌲🌲🌲🌲🌲🌲🌲🌲🌲🌲🌲🌲🌲🌲🌲🌲🌲🌲🌲🌲🌲🌲🌲🌲🌲🌲🌲🌲🌲🌲🌲🌲🌲🌲🌲🏔🏔🏔🏔🏔🏔🏔🏔🏔🏔🏔🏔🏔🏔🏔🏔🏔🏔🏔🏔🏔🏔🏔🏔🏔🏔🏔🏔🏔🏔🏔🏔🏔🏔🏔🏔🏔🏔🏔🏔🏔🏔🏔🏔🏔🏔🏔🏔
🏔🏔🏔🏔🏔🏔🏔🏔🏔🏔🏔🏔🏔🏔🏔🏔🏔🌲🌲🌲🌲🌲🌲🌲🌲🌲🌲🌲🌲🌲🌲🌲🌲🌲🌲🌲🌲🌲🌲🌲🌲🌲🌲🌲🌲🌲🌲🌲🌲🌲🌲🏔🏔🏔🏔🏔🏔🏔🏔🏔🏔🏔🏔🏔🏔🏔🏔🏔🏔🏔🏔🏔🏔🏔🏔🏔🏔🏔🏔🏔🏔🏔🏔🏔🏔🏔🏔🏔🏔🏔🏔🏔🏔🏔🏔🏔🏔🏔🏔🏔
🏔🏔🏔🏔🏔🏔🏔🏔🏔🏔🏔🏔🏔🏔🏔🏔🏔🏔🌲🌲🌲🌲🌲🌲🌲🌲🌲🌲🌲🌲🌲🌲🌲🌲🌲🌲🌲🌲🌲🌲🌲🌲🌲🌲🌲🌲🌲🌲🌲🌲🌲🏔🏔🏔🏔🏔🏔🏔🏔🏔🏔🏔🏔🏔🏔🏔🏔🏔🏔🏔🏔🏔🏔🏔🏔🏔🏔🏔🏔🏔🏔🏔🏔🏔🏔🏔🏔🏔🏔🏔🏔🏔🏔🏔🏔🏔🏔🏔🏔🏔
🏔🏔🏔🏔🏔🏔🏔🏔🏔🏔🏔🏔🏔🏔🏔🏔🏔🏔🏔🌲🌲🌲🌲🌲🌲🌲🌲🌲🌲🌲🌲🌲🌲🌲🌲🌲🌲🌲🌲🌲🌲🌲🌲🌲🌲🌲🌲🌲🌲🌲🌲🏔🏔🏔🏔🏔🏔🏔🏔🏔🏔🏔🏔🏔🏔🏔🏔🏔🏔🏔🏔🏔🏔🏔🏔🏔🏔🏔🏔🏔🏔🏔🏔🏔🏔🏔🏔🏔🏔🏔🏔🏔🏔🏔🏔🏔🏔🏔🏔🏔
🏔🏔🏔🏔🏔🏔🏔🏔🏔🏔🏔🏔🏔🏔🏔🏔🏔🏔🏔🌲🌲🌲🌲🌲🌲🌲🌲🌲🌲🌲🌲🌲🌲🌲🌲🌲🌲🌲🌲🌲🌲🌲🌲🌲🌲🌲🌲🌲🌲🌲🌲🏔🏔🏔🏔🏔🏔🏔🏔🏔🏔🏔🏔🏔🏔🏔🏔🏔🏔🏔🏔🏔🏔🏔🏔🏔🏔🏔🏔🏔🏔🏔🏔🏔🏔🏔🏔🏔🏔🏔🏔🏔🏔🏔🏔🏔🏔🏔🏔🏔
🏔🏔🏔🏔🏔🏔🏔🏔🏔🏔🏔🏔🏔🏔🏔🏔🏔🏔🏔🏔🌲🌲🌲🌲🌲🌲🌲🌲🌲🌲🌲🌲🌲🌲🌲🌲🌲🌲🌲🌲🌲🌲🌲🌲🌲🌲🌲🌲🌲🌲🌲🌲🏔🏔🏔🏔🏔🏔🏔🏔🏔🏔🏔🏔🏔🏔🏔🏔🏔🏔🏔🏔🏔🏔🏔🏔🏔🏔🏔🏔🏔🏔🏔🏔🏔🏔🏔🏔🏔🏔🏔🏔🏔🏔🏔🏔🏔🏔🏔🏔
🏔🏔🏔🏔🏔🏔🏔🏔🏔🏔🏔🏔🏔🏔🏔🏔🏔🏔🏔🏔🌲🌲🌲🌲🌲🌲🌲🌲🌲🌲🌲🌲🌲🌲🌲🌲🌲🌲🌲🌲🌲🌲🌲🌲🌲🌲🌲🌲🌲🌲🌲🌲🌲🌲🌲🌲🌲🏔🏔🏔🏔🏔🏔🏔🏔🏔🏔🏔🏔🏔🏔🏔🏔🏔🏔🏔🏔🏔🏔🏔🏔🏔🏔🏔🏔🏔🏔🏔🏔🏔🏔🏔🏔🏔🏔🏔🏔🏔🏔🏔
🏔🏔🏔🏔🏔🏔🏔🏔🏔🏔🏔🏔🏔🏔🏔🏔🏔🏔🏔🏔🏔🌲🌲🌲🌲🌲🌲🌲🌲🌲🌲🌲🌲🌲🌲🌲🌲🌲🌲🌲🌲🌲🌲🌲🌲🌲🌲🌲🌲🌲🌲🌲🌲🌲🌲🌲🌲🌲🌲🏔🏔🏔🏔🏔🏔🏔🏔🏔🏔🏔🏔🏔🏔🏔🏔🏔🏔🏔🏔🏔🏔🏔🏔🏔🏔🏔🏔🏔🏔🏔🏔🏔🏔🏔🏔🏔🏔🏔🏔🏔
🏔🏔🏔🏔🏔🏔🏔🏔🏔🏔🏔🏔🏔🏔🏔🏔🏔🏔🏔🏔🏔🌲🌲🌲🌲🌲🌲🌲🌲🌲🌲🌲🌲🌲🌲🌲🌲🌲🌲🌲🌲🌲🌲🌲🌲🌲🌲🌲🌲🌲🌲🌲🌲🌲🌲🌲🌲🌲🌲🏔🏔🏔🏔🏔🏔🏔🏔🏔🏔🏔🏔🏔🏔🏔🏔🏔🏔🏔🏔🏔🏔🏔🏔🏔🏔🏔🏔🏔🏔🏔🏔🏔🏔🏔🏔🏔🏔🏔🏔🏔
🏔🏔🏔🏔🏔🏔🏔🏔🏔🏔🏔🏔🏔🏔🏔🏔🏔🏔🏔🏔🏔🌲🌲🌲🌲🌲🌲🌲🌲🌲🌲🌲🌲🌲🌲🌲🌲🌲🌲🌲🌲🌲🌲🌲🌲🌲🌲🌲🌲🌲🌲🌲🌲🌲🌲🌲🌲🌲🌲🏔🏔🏔🏔🏔🏔🏔🏔🏔🏔🏔🏔🏔🏔🏔🏔🏔🏔🏔🏔🏔🏔🏔🏔🏔🏔🏔🏔🏔🏔🏔🏔🏔🏔🏔🏔🏔🏔🏔🏔🏔
