🏔🌲🌲🌲🏢🌴🌴🌴🌴🌴🌴🌴🏖🏖🏖🏖🏖🏖🏖🌊🌊🌊🌊🌊🌊🌊🌊🌊🌊🌊🏖🏖🏖🏖🏖🏖🏖🏖🏖🏖🏖🏖🏖🏖🌴🌴🌴🌴🌴🌴🌴🌴🌴🌴🌴🌴🌴🌴🌴🏢🌲🌲🌲🌲🌲🌲🌲🌲🌲🌲🌲🌲🌲🌲🌲🌲🌲🌲🌲🌲🌲🌲🌲🌲🌲🌲🌲🌲🏔🌲🌲🌲🌲🌲🌲🏔🏔🏔🏔🏔
🏔🌲🌲🏢🏢🌴🌴🌴🌴🌴🌴🌴🏖🏖🏖🏖🏖🏖🏖🌊🌊🌊🌊🌊🌊🌊🌊🌊🌊🌊🌊🌊🏖🏖🏖🏖🏖🏖🏖🏖🌊🏖🏖🏖🌴🌴🌴🌴🌴🌴🌴🌴🌴🌴🌴🌴🌴🌴🌴🏢🏢🌲🌲🌲🌲🌲🌲🌲🌲🌲🌲🌲🌲🌲🌲🌲🌲🌲🌲🌲🌲🌲🌲🌲🌲🌲🌲🌲🏔🌲🌲🌲🌲🌲🌲🏔🏔🏔🏔🏔
🏔🌲🌲🏢🏢🌴🌴🌴🌴🌴🌴🏖🏖🏖🏖🏖🏖🏖🏖🌊🌊🌊🌊🌊🌊🌊🌊🌊🌊🌊🌊🌊🌊🌊🏖🏖🏖🏖🏖🏖🏖🏖🏖🌴🌴🌴🌴🌴🌴🌴🌴🌴🌴🌴🌴🌴🌴🌴🌴🌴🏢🏢🏢🏢🏢🏢🌲🌲🌲🌲🌲🌲🌲🌲🌲🌲🌲🌲🌲🌲🌲🌲🌲🌲🌲🌲🌲🌲🏔🌲🌲🌲🌲🌲🌲🏔🏔🏔🏔🏔
🌲🌲🌲🌲🏢🌴🌴🌴🌴🌴🏖🏖🏖🏖🏖🏖🏖🏖🌊🌊🌊🌊🌊🌊🌊🌊🌊🌊🌊🌊🌊🌊🌊🌊🌊🏖🏖🏖🏖🏖🏖🏖🌴🌴🌴🌴🌴🌴🌴🌴🌴🌴🌴🌴🌴🌴🌴🌴🌴🌴🌴🌴🌴🏢🏢🏢🏢🏢🌲🌲🌲🌲🌲🌲🌲🌲🌲🌲🌲🌲🌲🌲🌲🌲🌲🌲🌲🌲🏔🌲🌲🌲🌲🌲🌲🏔🏔🏔🏔🏔
🌲🌲🌲🌲🏢🏢🌴🌴🌴🌴🏖🏖🏖🏖🌊🌊🌊🌊🌊🌊🌊🌊🌊🌊🌊🌊🌊🌊🌊🌊🌊🌊🌊🌊🏖🏖🏖🏖🏖🏖🏖🌴🌴🌴🌴🌴🌴🌴🌴🌴🌴🌴🌴🌴🌴🌴🌴🌴🌴🌴🌴🌴🌴🌴🌴🏢🏢🏢🌲🌲🌲🌲🌲🌲🌲🌲🌲🌲🌲🌲🌲🌲🌲🌲🌲🌲🌲🏔🏔🌲🌲🌲🌲🌲🌲🌲🏔🏔🏔🏔
🌲🌲🌲🌲🌲🏢🌴🌴🌴🌴🏖🏖🏖🏖🌊🌊🌊🌊🌊🌊🌊🌊🌊🌊🌊🌊🌊🌊🌊🌊🌊🌊🌊🌊🏖🏖🏖🏖🏖🏖🌴🌴🌴🌴🌴🌴🌴🌴🌴🌴🌴🌴🌴🌴🌴🏖🏖🌴🌴🌴🌴🌴🌴🌴🌴🌴🏢🏢🌲🌲🌲🌲🌲🌲🌲🌲🌲🌲🌲🌲🌲🌲🌲🌲🌲🏔🏔🏔🌲🌲🌲🌲🌲🌲🌲🌲🌲🌲🌲🌲
🌲🌲🌲🌲🌲🏢🌴🌴🌴🌴🏖🏖🏖🏖🌊🌊🌊🌊🌊🌊🌊🌊🌊🌊🌊🌊🌊🌊🌊🌊🌊🌊🌊🌊🏖🏖🏖🏖🏖🏖🏖🏖🏖🏖🏖🏖🏖🏖🏖🏖🏖🏖🏖🏖🌴🌴🌴🌴🌴🌴🌴🌴🌴🌴🌴🏢🏢🏢🌲🌲🌲🌲🌲🌲🌲🌲🌲🌲🌲🌲🌲🌲🌲🏔🏔🏔🏔🌲🌲🌲🌲🌲🌲🌲🌲🌲🌲🌲🌲🌲
🌲🌲🌲🌲🌲🏢🌴🌴🌴🌴🌴🏖🏖🏖🏖🌊🌊🌊🌊🌊🌊🌊🌊🌊🌊🌊🌊🌊🌊🌊🌊🌊🌊🌊🌊🌊🌊🌊🏖🏖🏖🏖🏖🏖🏖🏖🏖🏖🏖🏖🏖🏖🏖🏖🌴🌴🌴🌴🌴🌴🌴🌴🌴🌴🏢🏢🏢🏢🌲🌲🌲🌲🌲🌲🌲🌲🌲🌲🌲🌲🌲🌲🏔🏔🌲🌲🌲🌲🌲🌲🌲🌲🌲🌲🌲🌲🌲🌲🌲🌲
🌲🌲🌲🌲🌲🏢🌴🌴🌴🌴🌴🌴🌴🏖🏖🌊🌊🌊🌊🌊🌊🌊🌊🌊🌊🌊🌊🌊🌊🌊🌊🌊🌊🌊🌊🌊🌊🌊🌊🌊🌊🌊🌊🌊🌊🌊🌊🌊🌊🌊🏖🏖🏖🏖🌴🌴🌴🌴🌴🌴🌴🌴🌴🏢🏢🏢🏢🌲🌲🌲🌲🌲🌲🌲🌲🌲🌲🌲🌲🌲🌲🏔🏔🏔🌲🌲🌲🌲🌲🌲🌲🌲🌲🌲🌲🌲🌲🌲🌲🌲
🌲🌲🌲🌲🌲🏢🏢🌴🌴🌴🌴🌴🌴🏖🏖🌊🌊🌊🌊🌊🌊🌊🌊🌊🌊🌊🌊🌊🌊🌊🌊🌊🌊🌊🌊🌊🌊🌊🌊🌊🌊🌊🌊🌊🌊🌊🌊🌊🏖🏖🏖🏖🏖🏖🏖🌴🌴🌴🌴🌴🌴🌴🌴🏢🏢🏢🌲🌲🌲🌲🌲🌲🌲🌲🌲🌲🌲🌲🌲🌲🌲🏔🏔🏔🏔🌲🌲🌲🌲🌲🌲🌲🌲🌲🌲🌲🌲🌲🌲🏔
🌲🌲🌲🌲🏢🏢🏢🏢🏢🌴🌴🌴🌴🌴🏖🌊🌊🌊🌊🌊🌊🌊🌊🌊🌊🌊🌊🌊🌊🌊🌊🌊🌊🌊🌊🌊🌊🌊🌊🌊🌊🌊🌊🌊🌊🌊🏖🏖🏖🏖🏖🏖🏖🏖🏖🌴🌴🌴🌴🌴🌴🌴🌴🏢🏢🏢🌲🌲🌲🌲🌲🌲🌲🌲🌲🌲🏔🏔🌲🌲🌲🏔🏔🏔🏔🏔🌲🌲🌲🌲🌲🌲🏔🏔🏔🏔🏔🏔🏔🏔
🌲🌲🏢🏢🏢🏢🏢🏢🏢🏢🌴🌴🌴🌴🏖🏖🌊🌊🌊🌊🌊🌊🌊🌊🌊🌊🌊🌊🌊🌊🌊🌊🌊🌊🌊🌊🌊🌊🌊🌊🌊🌊🌊🌊🌊🌊🏖🏖🏖🏖🏖🏖🏖🏖🏖🏖🌴🌴🌴🌴🌴🌴🌴🏢🏢🌲🌲🌲🌲🌲🌲🌲🌲🌲🌲🌲🏔🏔🏔🏔🏔🏔🏔🏔🏔🏔🏔🏔🌲🌲🏔🏔🏔🏔🏔🏔🏔🏔🏔🏔
🌲🌲🏢🏢🏢🏢🏢🏢🏢🏢🌴🌴🌴🌴🏖🏖🌊🌊🌊🌊🌊🌊🌊🌊🌊🌊🌊🌊🌊🌊🌊🌊🌊🌊🌊🌊🌊🌊🌊🌊🌊🌊🌊🌊🌊🌊🏖🏖🏖🏖🏖🏖🏖🏖🏖🌴🌴🌴🌴🌴🌴🌴🏢🏢🏢🌲🌲🌲🌲🌲🌲🌲🌲🌲🌲🌲🌲🌲🌲🌲🏔🏔🏔🏔🏔🌲🏔🏔🏔🏔🏔🏔🌲🌲🌲🌲🏔🌲🌲🌲
🌲🌲🌲🏢🏢🏢🏢🏢🏢🏢🌴🌴🌴🌴🏖🏖🏖🌊🌊🌊🌊🌊🌊🌊🌊🌊🌊🌊🌊🌊🌊🌊🌊🌊🌊🌊🌊🌊🌊🌊🌊🌊🌊🌊🌊🌊🏖🏖🏖🏖🏖🏖🏖🏖🌴🌴🌴🌴🌴🌴🏢🏢🏢🏢🌲🌲🌲🌲🌲🌲🌲🌲🌲🌲🌲🌲🌲🌲🌲🌲🌲🏔🏔🏔🌲🌲🌲🌲🏔🏔🏔🌲🌲🌲🌲🌲🌲🌲🌲🌲
🌲🌲🌲🏢🏢🏢🏢🏢🏢🏢🌴🌴🌴🌴🌴🏖🏖🏖🏖🌊🌊🌊🌊🌊🌊🌊🌊🌊🌊🌊🌊🌊🌊🌊🌊🌊🌊🌊🌊🌊🌊🌊🌊🌊🌊🌊🏖🏖🏖🏖🏖🏖🏖🏖🌴🌴🌴🌴🌴🏢🏢🏢🏢🏢🌲🌲🌲🌲🌲🌲🌲🌲🌲🌲🌲🌲🌲🌲🌲🌲🌲🌲🏔🌲🌲🌲🌲🌲🌲🌲🌲🌲🌲🌲🌲🌲🌲🌲🌲🌲
🌲🌲🌲🏢🏢🏢🌴🌴🌴🌴🌴🌴🌴🌴🌴🌴🌴🌴🏖🏖🏖🏖🏖🌊🌊🌊🌊🌊🌊🌊🌊🌊🌊🌊🌊🌊🌊🌊🌊🌊🌊🌊🌊🌊🌊🌊🌊🏖🌊🌊🏖🏖🏖🌴🌴🌴🌴🌴🌴🏢🏢🏢🏢🏢🌲🌲🌲🌲🌲🌲🏢🏢🏢🏢🌲🌲🌲🌲🌲🌲🌲🌲🌲🌲🌲🌲🌲🌲🌲🌲🌲🌲🌲🌲🌲🌲🌲🌲🌲🌲
🌲🌲🌲🏢🏢🌴🌴🌴🌴🌴🌴🌴🌴🌴🌴🌴🌴🌴🌴🌴🏖🏖🏖🏖🏖🌊🌊🌊🌊🌊🌊🌊🌊🌊🌊🌊🌊🌊🌊🏖🏖🌊🌊🌊🌊🌊🌊🏖🌊🌊🏖🏖🏖🌴🌴🌴🌴🌴🌴🌴🏢🏢🏢🏢🏢🏢🌲🌲🌲🏢🏢🏢🏢🏢🏢🌲🌲🌲🌲🌲🌲🌲🌲🌲🌲🌲🌲🌲🌲🌲🌲🌲🌲🌲🌲🌲🌲🌲🌲🌲
🏢🏢🏢🏢🏢🏢🌴🌴🌴🌴🌴🌴🌴🌴🌴🌴🌴🌴🌴🌴🌴🌴🌴🏖🏖🏖🌊🌊🌊🌊🌊🌊🌊🌊🌊🌊🌊🌊🏖🏖🏖🏖🌊🌊🌊🌊🌊🏖🏖🏖🏖🏖🏖🌴🌴🌴🌴🌴🌴🌴🌴🌴🌴🌴🏢🏢🏢🏢🏢🏢🏢🌴🌴🌴🏢🏢🌲🌲🌲🌲🌲🌲🌲🌲🌲🌲🌲🌲🌲🌲🌲🌲🌲🌲🌲🌲🌲🌲🌲🌲
🏢🏢🏢🏢🏢🏢🌴🌴🌴🏢🏢🏢🌴🌴🌴🌴🌴🌴🌴🌴🌴🌴🌴🌴🏖🏖🏖🌊🌊🌊🌊🌊🌊🌊🌊🌊🌊🌊🏖🏖🏖🏖🌊🌊🌊🌊🌊🏖🏖🏖🏖🏖🏖🌴🌴🌴🌴🌴🌴🌴🌴🌴🌴🌴🌴🌴🏢🏢🏢🏢🌴🌴🌴🌴🌴🏢🏢🌲🌲🌲🌲🌲🌲🌲🌲🌲🌲🌲🌲🌲🌲🌲🌲🌲🌲🌲🌲🌲🌲🌲
🌴🌴🏢🏢🏢🌴🌴🏢🏢🏢🏢🏢🏢🌴🌴🌴🌴🌴🌴🌴🌴🌴🌴🌴🌴🏖🏖🌊🌊🌊🌊🌊🌊🌊🌊🌊🌊🌊🏖🏖🏖🏖🌊🌊🌊🌊🌊🏖🏖🏖🏖🏖🏖🏖🏖🏖🏖🌴🌴🌴🌴🌴🌴🌴🌴🌴🌴🏢🏢🌴🌴🌴🌴🌴🌴🏢🏢🏢🌲🌲🏢🏢🏢🏢🏢🏢🌲🌲🌲🌲🌲🌲🌲🌲🌲🌲🌲🌲🌲🌲
🌴🌴🌴🌴🌴🌴🌴🏢🏢🏢🏢🏢🏢🏢🏢🌴🌴🌴🌴🌴🌴🌴🌴🌴🌴🏖🏖🏖🌊🌊🌊🌊🌊🌊🌊🌊🌊🌊🏖🏖🏖🏖🌊🌊🌊🌊🏖🏖🏖🏖🏖🏖🏖🏖🏖🏖🏖🏖🏖🌴🌴🌴🌴🌴🌴🌴🌴🌴🌴🌴🌴🌴🌴🌴🌴🌴🏢🏢🏢🏢🏢🌴🌴🌴🏢🏢🌲🌲🌲🌲🌲🌲🌲🌲🌲🌲🌲🌲🌲🌲
🌴🌴🌴🌴🌴🌴🌴🏢🏢🏢🏢🏢🏢🏢🏢🏢🏢🏢🏢🌴🌴🌴🌴🌴🌴🌴🏖🏖🌊🌊🌊🌊🌊🌊🌊🌊🌊🌊🌊🌊🏖🌊🌊🌊🌊🌊🏖🏖🏖🏖🏖🏖🏖🏖🏖🏖🏖🏖🏖🏖🌴🌴🌴🌴🌴🌴🌴🌴🌴🌴🌴🌴🌴🌴🌴🌴🌴🌴🏢🌴🌴🌴🌴🌴🌴🏢🏢🌲🌲🌲🌲🌲🌲🌲🌲🌲🌲🌲🌲🌲
🌴🌴🌴🌴🌴🌴🌴🌴🏢🏢🌲🌲🌲🏢🏢🏢🏢🏢🏢🌴🌴🌴🌴🌴🌴🌴🏖🏖🌊🌊🌊🌊🌊🌊🌊🌊🌊🌊🌊🌊🌊🌊🌊🌊🌊🌊🏖🏖🏖🏖🏖🏖🏖🏖🏖🏖🏖🏖🏖🏖🌴🌴🌴🌴🌴🌴🌴🌴🌴🌴🌴🌴🌴🌴🌴🌴🌴🌴🌴🌴🌴🌴🌴🌴🌴🏢🏢🌲🌲🌲🌲🌲🌲🌲🌲🌲🌲🌲🌲🏔
🌴🌴🌴🌴🌴🌴🌴🌴🏢🏢🌲🌲🌲🌲🌲🌲🌲🌲🏢🏢🌴🌴🌴🌴🌴🌴🏖🏖🏖🌊🌊🌊🌊🌊🌊🌊🌊🌊🌊🌊🌊🌊🌊🌊🌊🏖🏖🏖🏖🏖🏖🏖🏖🏖🏖🏖🏖🏖🏖🏖🌴🌴🌴🌴🌴🌴🌴🌴🌴🌴🌴🌴🌴🌴🌴🌴🌴🌴🌴🌴🌴🌴🌴🌴🌴🏢🏢🌲🌲🌲🌲🌲🌲🌲🌲🌲🌲🏔🏔🏔
🌴🌴🌴🌴🌴🌴🌴🌴🏢🏢🌲🌲🌲🏢🌲🌲🌲🌲🌲🏢🏢🌴🌴🌴🌴🌴🌴🏖🏖🌊🌊🏖🏖🏖🌊🌊🌊🌊🌊🌊🌊🌊🌊🌊🌊🏖🏖🌴🏖🏖🏖🏖🏖🏖🏖🏖🏖🏖🏖🌴🌴🌴🌴🌴🌴🌴🌴🌴🌴🌴🌴🌴🌴🌴🌴🌴🌴🌴🌴🌴🌴🌴🌴🌴🌴🏢🏢🌲🌲🌲🌲🌲🌲🌲🌲🏔🏔🏔🏔🏔
🌴🌴🌴🌴🌴🌴🌴🌴🏢🏢🏢🏢🏢🏢🏢🌲🌲🌲🌲🌲🏢🌴🌴🌴🌴🌴🌴🏖🏖🏖🏖🏖🏖🏖🏖🌊🌊🌊🌊🌊🌊🌊🌊🌊🌊🏖🌴🌴🌴🌴🌴🌴🏖🏖🏖🏖🏖🏖🌴🌴🌴🌴🌴🌴🌴🌴🌴🌴🌴🌴🌴🌴🌴🌴🌴🌴🌴🌴🌴🌴🌴🌴🌴🌴🌴🌴🏢🌲🌲🌲🌲🌲🌲🌲🏔🏔🏔🏔🏔🌲
🌴🌴🌴🌴🌴🌴🌴🌴🏢🏢🏢🏢🏢🏢🏢🌲🌲🌲🌲🌲🏢🏢🌴🌴🌴🌴🌴🌴🏖🏖🏖🏖🏖🏖🏖🏖🌊🌊🌊🌊🌊🌊🌊🌊🏖🏖🌴🌴🌴🌴🌴🌴🌴🌴🏖🏖🏖🌴🌴🌴🌴🌴🌴🌴🌴🌴🌴🌴🌴🌴🌴🌴🌴🌴🌴🌴🌴🌴🌴🌴🌴🌴🌴🌴🌴🌴🏢🌲🌲🌲🌲🌲🌲🌲🏔🏔🏔🏔🌲🌲
🌴🌴🌴🌴🌴🌴🌴🌴🌴🏢🏢🏢🏢🏢🏢🏢🌲🌲🌲🌲🏢🏢🌴🌴🌴🌴🌴🌴🌴🏖🏖🏖🏖🌴🏖🏖🏖🌊🌊🌊🌊🌊🌊🌊🏖🏖🌴🌴🌴🌴🌴🌴🌴🌴🌴🌴🌴🌴🌴🌴🌴🌴🌴🌴🌴🌴🌴🌴🌴🌴🌴🌴🌴🌴🌴🌴🌴🌴🌴🌴🌴🌴🌴🌴🌴🌴🏢🌲🌲🌲🌲🌲🌲🏔🏔🏔🏔🌲🌲🌲
🌴🌴🌴🌴🌴🌴🌴🌴🌴🌴🌴🌴🌴🌴🌴🏢🌲🌲🌲🌲🏢🏢🏢🌴🌴🌴🌴🌴🌴🌴🌴🌴🌴🌴🌴🌴🏖🏖🌊🌊🌊🌊🌊🏖🏖🌴🌴🌴🌴🌴🌴🌴🌴🌴🌴🌴🌴🌴🌴🌴🌴🌴🌴🌴🌴🌴🌴🌴🌴🌴🌴🌴🌴🌴🌴🌴🌴🌴🌴🌴🌴🌴🌴🌴🌴🌴🏢🏢🌲🌲🌲🌲🌲🏔🏔🏔🏔🌲🌲🌲
🌴🏢🏢🏢🌴🌴🌴🌴🌴🌴🌴🌴🌴🌴🌴🏢🏢🌲🌲🌲🏢🏢🏢🏢🌴🌴🌴🌴🌴🌴🌴🌴🌴🌴🌴🌴🌴🌴🏖🏖🏖🏖🏖🌴🌴🌴🌴🌴🌴🌴🌴🌴🌴🌴🌴🌴🌴🌴🌴🌴🌴🌴🌴🌴🌴🌴🌴🌴🌴🌴🌴🌴🌴🌴🌴🌴🏖🏖🏖🏖🏖🏖🏖🌴🌴🌴🌴🏢🌲🌲🌲🌲🌲🏔🏔🏔🌲🌲🌲🌲
🌴🏢🏢🏢🏢🌴🌴🌴🌴🌴🌴🌴🌴🌴🌴🏢🏢🏢🏢🏢🏢🏢🏢🏢🌴🌴🌴🌴🌴🌴🌴🌴🌴🌴🌴🌴🌴🌴🌴🌴🌴🌴🌴🌴🌴🌴🌴🌴🌴🌴🌴🌴🌴🌴🌴🌴🌴🌴🌴🌴🌴🌴🌴🌴🌴🌴🌴🌴🌴🌴🌴🌴🌴🌴🏖🏖🏖🏖🏖🏖🏖🏖🏖🏖🌴🌴🌴🏢🏢🌲🌲🌲🌲🌲🌲🌲🌲🌲🌲🌲
🌴🏢🏢🏢🏢🏢🌴🌴🌴🌴🌴🌴🌴🌴🌴🏢🏢🏢🏢🏢🏢🏢🏢🏢🌴🌴🌴🌴🌴🌴🌴🌴🌴🌴🌴🌴🌴🌴🌴🌴🌴🌴🌴🌴🌴🌴🌴🌴🌴🌴🌴🌴🌴🌴🌴🌴🌴🌴🌴🌴🌴🌴🌴🌴🌴🌴🌴🌴🌴🌴🌴🌴🌴🌴🏖🏖🌊🌊🌊🌊🌊🌊🏖🏖🌴🌴🌴🏢🏢🌲🌲🌲🌲🌲🌲🌲🌲🌲🌲🌲
🌴🌴🏢🏢🏢🏢🏢🌴🌴🌴🌴🌴🌴🌴🌴🏢🏢🏢🏢🏢🏢🏢🏢🏢🏢🌴🌴🌴🌴🌴🌴🌴🌴🌴🏢🏢🏢🏢🏢🏢🏢🏢🏢🏢🏢🏢🏢🌴🌴🌴🌴🌴🌴🌴🌴🌴🌴🌴🌴🏢🏢🏢🌴🌴🌴🌴🌴🌴🌴🌴🌴🌴🌴🏖🏖🌊🌊🌊🌊🌊🌊🌊🌊🏖🏖🌴🌴🏢🏢🌲🌲🌲🌲🌲🌲🌲🌲🌲🌲🌲
🌴🌴🏢🏢🏢🏢🏢🏢🏢🌴🌴🌴🌴🌴🏢🏢🏢🏢🏢🏢🏢🏢🏢🏢🏢🏢🏢🌴🌴🌴🌴🌴🏢🏢🏢🌲🌲🌲🌲🌲🌲🌲🌲🌲🌲🌲🏢🏢🏢🏢🏢🏢🌴🌴🌴🌴🌴🌴🏢🏢🏢🏢🌴🌴🌴🌴🌴🌴🌴🌴🌴🌴🏖🏖🌊🌊🌊🌊🌊🌊🌊🌊🌊🌊🏖🌴🌴🏢🏢🌲🌲🌲🌲🌲🌲🌲🌲🌲🌲🌲
🌴🌴🌴🏢🏢🏢🏢🏢🏢🏢🌴🌴🌴🌴🏢🏢🏢🏢🏢🌲🌲🌲🌲🌲🌲🌲🏢🏢🏢🏢🏢🏢🏢🌲🌲🌲🌲🌲🌲🌲🌲🌲🌲🌲🌲🌲🌲🏢🏢🏢🏢🏢🌴🌴🌴🌴🌴🏢🏢🏢🏢🏢🏢🌴🌴🌴🌴🏖🏖🏖🌴🏖🏖🌊🌊🌊🌊🌊🌊🌊🌊🌊🌊🌊🏖🌴🌴🌴🏢🌲🌲🌲🌲🌲🌲🌲🌲🌲🌲🌲
🌴🌴🌴🏢🏢🏢🏢🏢🏢🏢🌴🌴🌴🌴🏢🏢🏢🏢🌲🌲🌲🌲🌲🌲🌲🌲🌲🌲🌲🌲🌲🌲🌲🌲🌲🌲🌲🌲🌲🌲🌲🌲🌲🌲🌲🌲🌲🌲🏢🏢🏢🏢🏢🌴🌴🌴🏢🏢🏢🏢🏢🏢🌴🌴🌴🌴🏖🏖🏖🏖🏖🏖🏖🌊🌊🌊🌊🌊🌊🌊🌊🌊🌊🌊🏖🌴🌴🌴🏢🌲🌲🌲🌲🌲🏔🏔🏔🏔🏔🏔
🌴🌴🌴🌴🌴🏢🏢🏢🏢🌴🌴🌴🌴🏢🏢🏢🏢🌲🌲🌲🌲🌲🌲🌲🌲🌲🌲🌲🌲🌲🌲🌲🌲🌲🌲🌲🌲🌲🌲🌲🌲🌲🌲🌲🌲🌲🌲🌲🌲🌲🏢🏢🏢🏢🏢🏢🏢🏢🏢🏢🏢🏢🌴🌴🌴🌴🏖🏖🏖🏖🏖🏖🌊🌊🌊🌊🌊🌊🌊🌊🌊🌊🌊🌊🏖🌴🌴🌴🏢🏢🌲🌲🌲🌲🏔🏔🏔🏔🏔🏔
🌴🌴🌴🌴🌴🌴🌴🌴🌴🌴🌴🌴🏢🏢🏢🏢🌲🌲🌲🌲🌲🌲🌲🌲🌲🌲🌲🌲🌲🌲🌲🌲🌲🌲🌲🌲🌲🌲🌲🌲🌲🌲🌲🌲🌲🌲🌲🌲🌲🌲🌲🌲🏢🏢🏢🏢🏢🏢🌲🏢🏢🌴🌴🌴🌴🌴🏖🏖🏖🏖🏖🏖🏖🌊🌊🌊🌊🌊🌊🌊🌊🌊🌊🌊🏖🌴🌴🌴🌴🏢🌲🌲🌲🌲🏔🏔🏔🏔🏔🏔
🌴🌴🌴🌴🌴🌴🌴🌴🌴🌴🌴🏢🏢🏢🏢🌲🌲🌲🌲🌲🌲🌲🌲🌲🌲🌲🌲🌲🌲🌲🌲🌲🌲🌲🌲🌲🌲🌲🌲🌲🌲🏔🏔🌲🌲🌲🌲🌲🌲🌲🌲🌲🌲🏢🏢🏢🏢🌲🌲🏢🏢🌴🌴🌴🌴🌴🏖🏖🏖🏖🏖🏖🏖🌊🌊🌊🌊🌊🌊🌊🌊🌊🌊🌊🏖🌴🌴🌴🌴🏢🌲🌲🌲🌲🏔🏔🏔🏔🏔🏔
🏖🌴🌴🌴🌴🌴🌴🌴🌴🌴🏢🏢🏢🌲🌲🌲🌲🌲🌲🌲🌲🏔🌲🌲🌲🌲🌲🌲🌲🌲🌲🌲🌲🌲🌲🏔🏔🏔🌲🏔🏔🏔🏔🏔🏔🏔🌲🌲🌲🌲🌲🌲🌲🏢🏢🏢🏢🌲🌲🏢🏢🌴🌴🌴🌴🌴🏖🏖🏖🏖🏖🏖🏖🏖🌊🌊🌊🌊🌊🌊🌊🌊🌊🌊🏖🌴🌴🌴🌴🏢🌲🌲🌲🌲🌲🏔🏔🏔🏔🏔
🏖🌴🌴🌴🌴🌴🌴🌴🌴🌴🏢🏢🌲🌲🌲🌲🌲🌲🌲🏔🏔🏔🏔🌲🌲🌲🌲🌲🌲🌲🌲🌲🏔🏔🏔🏔🏔🏔🏔🏔🏔🌲🌲🌲🌲🏔🏔🌲🌲🌲🌲🌲🌲🏢🏢🏢🏢🏢🌲🌲🏢🏢🌴🌴🌴🌴🌴🌴🌴🌴🌴🌴🏖🏖🏖🌊🌊🌊🌊🌊🌊🌊🌊🌊🏖🌴🌴🌴🌴🏢🌲🌲🌲🌲🌲🌲🏔🏔🏔🏔
🏖🏖🌴🌴🌴🌴🌴🌴🌴🌴🏢🏢🌲🌲🌲🌲🌲🌲🏔🏔🏔🏔🏔🏔🏔🏔🏔🏔🏔🏔🏔🏔🏔🏔🏔🏔🏔🏔🏔🌲🌲🌲🌲🌲🌲🏔🏔🌲🌲🌲🌲🌲🌲🏢🏢🏢🏢🏢🌲🌲🌲🏢🌴🌴🌴🌴🌴🌴🌴🌴🌴🌴🌴🏖🏖🌊🌊🌊🌊🌊🌊🌊🌊🏖🏖🌴🌴🌴🏢🌲🌲🌲🌲🌲🌲🌲🏔🏔🏔🏔
🏖🌴🌴🌴🌴🌴🌴🌴🌴🌴🌴🏢🌲🌲🌲🌲🌲🌲🏔🏔🌲🌲🌲🏔🏔🏔🏔🏔🌲🌲🌲🌲🌲🌲🌲🌲🌲🌲🌲🌲🌲🌲🌲🌲🌲🏔🏔🌲🌲🌲🌲🌲🌲🏢🏢🏢🏢🌲🌲🌲🌲🌲🏢🌴🌴🌴🌴🌴🌴🌴🌴🌴🌴🌴🏖🏖🌊🌊🌊🌊🌊🌊🏖🏖🏖🌴🌴🌴🏢🌲🌲🌲🌲🌲🌲🏔🏔🏔🏔🏔
🏖🌴🌴🌴🌴🌴🌴🌴🌴🌴🌴🏢🏢🌲🌲🌲🌲🌲🏔🏔🌲🌲🌲🌲🌲🌲🌲🌲🌲🌲🌲🌲🌲🌲🌲🌲🌲🌲🌲🌲🌲🌲🌲🏔🏔🏔🏔🌲🌲🌲🌲🌲🌲🏢🏢🏢🏢🌲🌲🌲🌲🌲🌲🏢🏢🌴🌴🌴🌴🌴🌴🌴🌴🌴🌴🌴🏖🏖🏖🌊🌊🏖🏖🏖🌴🌴🌴🌴🌲🌲🌲🌲🌲🏔🏔🏔🏔🏔🏔🏔
🌴🌴🌴🌴🌴🌴🌴🌴🌴🌴🌴🌴🏢🏢🌲🌲🌲🌲🏔🏔🌲🌲🌲🌲🌲🌲🌲🌲🌲🌲🌲🌲🏡🌲🌲🌲🌲🌲🌲🌲🌲🌲🌲🏔🏔🏔🏔🌲🌲🌲🌲🌲🌲🌲🏢🏢🌲🌲🌲🌲🌲🌲🌲🏢🏢🏢🏢🏢🏢🏢🌴🌴🌴🌴🌴🌴🌴🌴🏖🏖🏖🏖🏖🌴🌴🌴🌴🏢🌲🌲🌲🌲🏔🏔🏔🏔🏔🏔🏔🏔
🌴🌴🌴🌴🌴🌴🌴🌴🌴🌴🌴🌴🌴🏢🌲🌲🌲🌲🏔🏔🌲🌲🌲🌲🌲🌲🌲🌲🌲🏡🏡🏡🏡🏡🏡🏡🏡🏡🏡🌲🌲🌲🌲🏔🏔🏔🌲🌲🌲🌲🌲🌲🌲🌲🌲🌲🌲🌲🌲🌲🌲🌲🌲🌲🌲🌲🌲🌲🌲🏢🏢🌴🌴🌴🌴🌴🌴🌴🌴🌴🏖🏖🌴🌴🌴🌴🌴🏢🌲🌲🌲🏔🏔🏔🏔🏔🏔🏔🏔🌲
🌴🌴🌴🌴🌴🌴🌴🌴🌴🌴🌴🌴🌴🏢🌲🌲🌲🌲🏔🏔🌲🌲🌲🌲🌲🌲🌲🌲🏡🏡🏡🌲🌲🌲🌲🌲🏡🏡🏡🏡🌲🌲🌲🏔🏔🏔🏔🏔🌲🌲🌲🌲🌲🌲🌲🌲🌲🌲🌲🌲🌲🌲🌲🌲🌲🌲🌲🌲🌲🌲🏢🏢🏢🏢🌴🌴🌴🌴🌴🌴🌴🌴🌴🌴🌴🌴🌴🏢🌲🌲🌲🏔🏔🏔🏔🏔🏔🏔🏔🌲
🌴🌴🌴🌴🌴🌴🌴🌴🌴🌴🌴🌴🌴🏢🌲🌲🌲🌲🏔🏔🌲🌲🌲🌲🌲🌲🌲🌲🏡🏡🌲🌲🌾🌾🌾🌲🌲🌲🌲🏡🏡🌲🌲🏔🏔🏔🏔🏔🏔🌲🌲🌲🌲🌲🌲🌲🌲🌲🌲🌲🌲🌲🌲🌲🌲🌲🌲🌲🌲🌲🏢🏢🏢🏢🏢🏢🌴🌴🌴🌴🌴🌴🌴🌴🌴🌴🌴🏢🌲🌲🌲🏔🏔🏔🌲🌲🏔🏔🏔🏔
🌴🌴🌴🌴🌴🌴🌴🌴🌴🌴🌴🌴🏢🏢🌲🌲🌲🌲🏔🌲🌲🌲🌲🌲🌲🌲🌲🌲🌲🏡🌲🌲🌾🌾🌾🌾🌲🌲🌲🌲🏡🌲🌲🌲🌲🌲🏔🏔🏔🌲🌲🌲🌲🌲🌲🌲🌲🌲🌲🌲🌲🌲🌲🌲🌲🌲🌲🌲🌲🌲🌲🌲🏢🏢🏢🏢🏢🌴🌴🌴🌴🌴🌴🌴🌴🌴🏢🏢🌲🌲🌲🌲🏔🏔🌲🌲🏔🏔🏔🏔
🌴🌴🌴🌴🌴🌴🌴🌴🌴🌴🌴🌴🏢🏢🌲🌲🌲🌲🏔🌲🌲🌲🌲🌲🌲🌲🌲🌲🌲🌲🏡🌲🌾🌾🌾🌾🌾🌲🌲🌲🏡🏡🌲🌲🌲🌲🌲🌲🏔🏔🌲🌲🌲🌲🌲🌲🌲🌲🏢🏢🌲🌲🌲🌲🌲🌲🌲🌲🌲🌲🌲🌲🌲🏢🏢🏢🌴🌴🌴🌴🌴🌴🌴🌴🌴🏢🏢🌲🌲🌲🌲🌲🏔🏔🌲🌲🌲🏔🏔🏔
🌴🌴🌴🌴🌴🌴🌴🌴🌴🌴🌴🌴🏢🏢🌲🌲🌲🌲🏔🏔🌲🌲🌲🌲🌲🌲🌲🌲🌲🌲🏡🌲🌾🌾🌾🌾🌾🌾🌾🌲🌲🏡🌲🌲🌲🌲🌲🌲🌲🏔🏔🏔🌲🌲🌲🌲🌲🌲🌲🏢🌲🌲🌲🌲🌲🌲🌲🌲🌲🌲🌲🌲🌲🏢🏢🏢🌴🌴🌴🌴🌴🌴🌴🌴🏢🏢🌲🌲🌲🌲🌲🌲🏔🏔🌲🌲🌲🏔🏔🏔
🌴🌴🌴🌴🌴🌴🌴🌴🌴🌴🌴🌴🏢🏢🌲🌲🌲🌲🏔🏔🌲🌲🌲🌲🌲🌲🌲🌲🌲🌲🏡🌲🌲🌾🌾🌾🌾🌾🌾🌲🌲🏡🏡🌲🌲🌲🌲🌲🌲🌲🌲🏔🏔🏔🌲🌲🌲🌲🌲🌲🌲🌲🌲🌲🌲🌲🌲🌲🌲🌲🌲🌲🌲🏢🏢🏢🌴🌴🌴🌴🌴🌴🌴🏢🏢🌲🌲🌲🌲🌲🌲🏔🏔🌲🌲🌲🌲🌲🏔🏔
🌴🌴🌴🌴🌴🌴🌴🌴🌴🌴🌴🌴🏢🏢🌲🌲🌲🌲🏔🏔🏔🌲🌲🌲🌲🌲🌲🌲🌲🌲🏡🌲🌲🌾🌾🌾🌾🌾🌾🌾🌲🏡🏡🌲🌲🌲🌲🌲🌲🌲🌲🌲🌲🌲🏔🌲🌲🌲🌲🌲🌲🌲🌲🌲🌲🌲🌲🌲🌲🌲🌲🌲🌲🏢🏢🏢🌴🌴🌴🌴🌴🌴🌴🏢🏢🌲🌲🌲🌲🌲🏔🏔🏔🌲🌲🌲🌲🌲🌲🏔
🌴🌴🌴🏢🏢🏢🏢🌴🌴🌴🌴🌴🏢🏢🌲🌲🌲🌲🏔🏔🏔🏔🌲🌲🌲🌲🌲🌲🌲🌲🏡🌲🌾🌾🌾🌾🌾🌾🌾🌲🌲🏡🏡🏡🌲🌲🏡🏡🏡🏡🌲🌲🌲🌲🌲🏔🌲🌲🌲🌲🌲🌲🌲🌲🌲🌲🏔🌲🌲🌲🌲🌲🌲🏢🏢🏢🌴🌴🌴🌴🌴🌴🏢🏢🌲🌲🌲🌲🌲🌲🏔🏔🏔🌲🌲🌲🌲🌲🌲🌲
🌴🌴🌴🏢🌲🌲🏢🏢🌴🌴🌴🌴🏢🏢🌲🌲🌲🌲🏔🏔🏔🏔🏔🏔🏔🌲🌲🌲🌲🌲🏡🌲🌾🌾🌾🌾🌾🌾🌾🌾🌲🌲🏡🏡🏡🏡🏡🏡🏡🏡🏡🌲🌲🌲🌲🏔🏔🌲🌲🌲🌲🌲🌲🌲🏔🏔🏔🏔🌲🌲🌲🌲🌲🌲🏢🏢🏢🌴🌴🌴🌴🏢🏢🏢🌲🌲🌲🌲🌲🌲🏔🏔🏔🌲🌲🌲🌲🌲🌲🌲
🌴🌴🏢🌲🌲🌲🌲🏢🏢🌴🌴🏢🏢🌲🌲🌲🌲🌲🌲🌲🌲🌲🌲🏔🏔🏔🌲🌲🌲🌲🏡🌲🌲🌾🌾🌾🌾🌾🌾🌾🌲🌲🌲🏡🏡🏡🏡🏡🏡🏡🏡🏡🌲🌲🌲🌲🏔🏔🌲🌲🌲🌲🌲🏔🏔🏔🏔🏔🏔🌲🌲🌲🌲🌲🌲🌲🌲🏢🏢🏢🏢🏢🏢🌲🌲🌲🌲🌲🌲🌲🏔🏔🏔🌲🌲🌲🌲🌲🌲🌲
🌴🏢🌲🌲🌲🌲🌲🌲🏢🏢🏢🏢🏢🌲🌲🌲🌲🌲🌲🌲🌲🌲🌲🌲🏔🏔🌲🌲🌲🌲🏡🏡🌲🌾🌾🌾🌾🌾🌾🌾🌲🌲🌲🌲🌲🌲🌲🏡🏡🏡🏡🏡🌲🌲🌲🌲🏔🏔🏔🏔🏔🏔🏔🏔🌲🌲🌲🌲🏔🏔🌲🌲🌲🌲🌲🌲🌲🌲🌲🌲🌲🌲🌲🌲🌲🌲🌲🌲🌲🌲🏔🏔🏔🌲🌲🌲🌲🌲🌲🌲
🏢🏢🌲🌲🌲🌲🌲🌲🏢🏢🏢🏢🌲🌲🌲🌲🌲🌲🌲🌲🌲🌲🌲🌲🌲🏔🏔🌲🌲🌲🌲🏡🌲🌲🌾🌾🌾🌾🌾🌾🌾🌲🌲🌲🌲🌲🌲🌲🏡🏡🏡🏡🌲🌲🌲🌲🌲🏔🏔🏔🏔🏔🏔🌲🌲🌲🌲🌲🌲🌲🏔🏔🌲🌲🌲🌲🌲🌲🌲🌲🌲🌲🌲🌲🌲🌲🌲🌲🌲🏔🏔🏔🌲🌲🌲🌲🌲🏡🏡🌲
🏢🌲🌲🌲🌲🌲🌲🌲🌲🌲🌲🌲🌲🌲🌲🌲🌲🌲🌲🌲🌲🌲🌲🌲🌲🏔🏔🌲🌲🌲🌲🏡🏡🌲🌾🌾🌾🌾🌾🌾🌾🌾🌲🌲🌲🌲🌲🌲🏡🏡🏡🏡🌲🌲🌲🌲🌲🌲🏔🏔🌲🌲🌲🌲🌲🌲🌲🌲🌲🌲🌲🌲🏔🏔🏔🏔🏔🌲🌲🌲🌲🌲🌲🌲🌲🌲🌲🌲🏔🏔🏔🏔🌲🌲🌲🌲🌲🏡🏡🏡
🌲🌲🌲🌲🌲🌲🌲🌲🌲🌲🌲🌲🌲🌲🌲🌲🌲🌲🌲🌲🌲🌲🌲🌲🌲🏔🏔🏔🌲🌲🌲🏡🏡🌲🌲🌾🌾🌾🌾🌾🌾🌾🌾🌲🌲🌲🌲🏡🏡🏡🏡🏡🌲🌲🌲🌲🌲🌲🌲🌲🌲🌲🌲🌲🌲🏡🏡🏡🏡🌲🌲🌲🌲🌲🌲🌲🌲🏔🏔🌲🌲🌲🏔🏔🏔🏔🏔🏔🏔🏔🏔🌲🌲🌲🌲🌲🌲🏡🌲🌲
🌲🌲🌲🌲🌲🌲🌲🌲🌲🌲🌲🌲🌲🌲🌲🌲🌲🌲🌲🌲🌲🌲🌲🌲🌲🏔🏔🏔🌲🌲🌲🏡🏡🌲🌲🌲🌾🌾🌾🌾🌾🌾🌾🌲🌲🌲🏡🏡🏡🏡🏡🏡🏡🏡🌲🌲🌲🌲🌲🌲🌲🌲🌲🏡🏡🏡🌲🌲🏡🏡🏡🌲🌲🌲🌲🌲🌲🌲🌲🏔🏔🌲🌲🌲🌲🌲🌲🌲🌲🌲🌲🌲🌲🌲🌲🌲🌲🌲🌲🌲
🌲🌲🌲🌲🌲🌲🌲🌲🌲🌲🌲🌲🌲🌲🌲🌲🌲🌲🌲🌲🌲🌲🌲🌲🏔🏔🏔🏔🌲🌲🌲🏡🌲🌲🌲🌲🌲🌲🌾🌾🌾🌾🌲🌲🌲🌲🏡🏡🏡🏡🏡🏡🏡🏡🏡🌲🌲🌲🌲🌲🌲🌲🏡🏡🏡🌲🌲🌲🌲🏡🏡🏡🌲🌲🏡🏡🏡🌲🌲🌲🌲🌲🌲🌲🏡🏡🏡🌲🌲🌲🌲🌲🌲🌲🌲🏡🏡🏡🌲🌲
🌲🌲🌲🌲🌲🌲🌲🏔🏔🌲🌲🌲🌲🌲🌲🌲🌲🌲🌲🌲🌲🌲🏔🏔🏔🏔🏔🏔🌲🌲🌲🏡🏡🌲🌲🌲🌲🌲🌾🌾🌾🌾🌾🌲🌲🌲🏡🏡🏡🏡🏡🏡🏡🏡🏡🏡🌲🌲🌲🌲🌲🏡🏡🏡🌲🌲🌲🌲🌲🌲🌲🏡🏡🏡🏡🏡🏡🏡🏡🏡🏡🏡🏡🌲🌲🌲🌲🌲🏡🏡🏡🏡🏡🏡🏡🏡🏡🏡🏡🌲
🏢🌲🌲🌲🌲🌲🏔🏔🏔🏔🌲🌲🌲🌲🌲🌲🌲🌲🌲🌲🌲🏔🏔🏔🏔🏔🏔🌲🌲🌲🌲🏡🏡🌲🌲🌲🌲🌲🌾🌾🌾🌾🌾🌲🌲🌲🏡🏡🏡🏡🌲🌲🌲🌲🏡🏡🏡🌲🌲🌲🌲🏡🏡🏡🏡🌲🌲🌾🌾🌾🌲🌲🌲🌲🌲🌲🌲🌲🌲🌲🌲🌲🌲🌾🌾🌾🌾🌾🌲🌲🌲🏡🏡🏡🏡🏡🏡🏡🏡🏡
🏢🌲🌲🌲🌲🌲🏔🏔🏔🏔🏔🏔🏔🏔🏔🏔🏔🏔🏔🏔🏔🏔🏔🌲🌲🌲🌲🌲🌲🌲🌲🏡🏡🏡🌲🌲🌲🌾🌾🌾🌾🌾🌾🌲🌲🌲🌲🏡🏡🌲🌲🌲🌲🌲🌲🏡🏡🏡🌲🌲🌲🏡🏡🏡🏡🌲🌾🌾🌾🌾🌾🌾🌾🌾🌾🌾🌾🌾🌾🌾🌾🌾🌾🌴🌴🌴🌴🌴🌾🌾🌲🌲🌲🌲🌲🏡🌲🌲🏡🏡
🏢🌲🌲🌲🌲🌲🏔🏔🏔🏔🏔🏔🏔🌲🌲🌲🏔🏔🏔🏔🏔🏔🌲🌲🌲🌲🌲🌲🌲🌲🌲🏡🏡🏡🌲🌲🌲🌾🌾🌾🌾🌾🌾🌲🌲🌲🌲🌲🌲🌲🌲🌲🌲🌲🌲🌲🏡🏡🏡🏡🏡🏡🏡🏡🌲🌲🌾🌾🌴🌴🌴🌴🌴🌴🌴🌴🌴🌴🌴🌴🌴🌴🌴🌴🌴🌴🌴🌴🌴🌾🌾🌲🌲🌲🌲🌲🌲🌲🌲🌲
🏢🌲🌲🌲🌲🌲🏔🏔🏔🌲🌲🌲🌲🌲🌲🌲🌲🌲🏔🏔🏔🏔🏔🌲🌲🌲🌲🌲🌲🌲🌲🏡🏡🌲🌲🌾🌾🌾🌾🌾🌾🌾🌾🌾🌲🌲🌲🌲🌲🌲🌲🌲🌲🌾🌲🌲🌲🌲🌲🌲🌲🌲🌲🌲🌲🌲🌾🌴🌴🌴🌴🌴🌴🌴🌴🌴🌴🌴🌴🌴🌴🌴🌴🌴🌴🌴🌴🌴🌴🌴🌾🌲🌲🌲🌲🌲🌲🌲🌲🌲
🏢🌲🌲🌲🌲🌲🏔🏔🏔🌲🌲🌲🌲🌲🌲🌲🌲🌲🌲🌲🏔🏔🏔🌲🌲🌲🌲🌲🌲🌲🌲🏡🏡🌲🌾🌾🌾🌾🌾🌾🌾🌾🌾🌾🌾🌾🌾🌾🌾🌾🌾🌾🌾🌾🌾🌾🌾🌾🌾🌾🌾🌾🌾🌾🌾🌾🌾🌴🌴🌴🌴🌴🌴🌴🌴🌴🌴🌴🌴🌴🌴🌴🌴🌴🌴🌴🌴🌴🌴🌴🌾🌾🌲🌲🌲🌲🌲🌲🌲🌲
🏢🌲🌲🌲🌲🌲🏔🏔🌲🌲🌲🌲🌲🌲🌲🌲🌲🌲🌲🌲🌲🌲🏔🌲🌲🌲🌲🌲🌲🌲🏡🏡🌲🌲🌾🌾🌾🌾🌾🌾🌾🌾🌾🌴🌴🌴🌴🌴🌴🌴🌴🌴🌴🌴🌴🌾🌾🌾🌾🌾🌾🌾🌾🌾🌾🌾🌴🌴🌴🌴🌴🌴🌴🌴🌴🌴🌴🌴🏖🌴🌴🌴🌴🌴🌴🌴🌴🌴🌴🌴🌾🌾🌲🌲🌲🌲🌲🌲🌲🏡
🌴🏢🌲🌲🌲🌲🏔🏔🌲🌲🌲🌲🌲🌲🌲🌲🌲🌲🌲🌲🌲🌲🌲🌲🌲🌲🌲🌲🏡🏡🏡🏡🌲🌾🌾🌾🌾🌾🌾🌾🌾🌴🌴🌴🌴🌴🌴🌴🌴🌴🌴🌴🌴🌴🌴🌴🌴🌴🌴🌴🌴🌴🌴🌴🌴🌴🌴🌴🌴🌴🌴🏖🏖🌴🌴🏖🏖🏖🏖🏖🌴🌴🌴🌴🌴🌴🌴🌴🌴🌴🌾🌾🌾🌾🌲🌲🌲🌲🌲🏡
🌴🏢🌲🌲🌲🌲🏔🌲🌲🌲🌲🌲🌲🌲🌲🌲🌲🌲🌲🌲🌲🌲🌲🌲🌲🌲🌲🌲🏡🏡🏡🌲🌲🌾🌴🌴🌴🌴🌴🌴🌴🌴🌴🌴🌴🌴🌴🌴🌴🌴🌴🌴🌴🌴🌴🌴🌴🌴🌴🌴🌴🌴🌴🌴🌴🌴🌴🌴🌴🌴🏖🏖🏖🏖🏖🏖🏖🏖🏖🏖🏖🌴🌴🌴🌴🌴🌴🌴🌴🌴🌾🌾🌾🌾🌾🌾🌾🌲🌲🏡
🌴🏢🌲🌲🌲🌲🏔🏔🌲🌲🌲🌲🌲🌲🌲🌲🌲🌲🌲🌲🌲🌲🌲🌲🌲🌲🌲🌲🏡🏡🌲🌲🌾🌾🌴🌴🌴🌴🌴🌴🌴🌴🌴🌴🌴🌴🌴🌴🌴🌴🌴🌴🌴🌴🌴🌴🌴🌴🌴🌴🌴🌴🌴🌴🌴🌴🌴🌴🌴🌴🏖🏖🏖🏖🏖🏖🏖🏖🏖🏖🏖🏖🌴🌴🌴🌴🌴🌴🌴🌴🌴🌾🌾🌾🌾🌾🌾🌲🌲🏡
🌴🏢🌲🌲🌲🌲🏔🏔🏔🏔🌲🌲🌲🌲🌲🌲🌲🌲🌲🌲🌲🌲🌲🌲🌲🌲🌲🌲🏡🏡🌲🌲🌾🌴🌴🌴🌴🌴🌴🌴🌴🌴🌴🌴🌴🏖🏖🏖🏖🏖🏖🏖🏖🏖🌴🌴🌴🌴🌴🌴🌴🌴🌴🌴🌴🌴🌴🌴🌴🌴🏖🏖🏖🏖🏖🏖🏖🏖🏖🏖🏖🏖🏖🏖🏖🌴🌴🌴🌴🌴🌴🌴🌴🌴🌴🌾🌾🌾🌲🏡
🌴🏢🌲🌲🌲🌲🌲🌲🏔🏔🏔🌲🌲🌲🌲🌲🌲🌲🌲🌲🌲🌲🌲🌲🌲🌲🌲🌲🏡🏡🌲🌾🌾🌴🌴🌴🌴🌴🌴🌴🌴🌴🌴🌴🏖🏖🏖🏖🏖🏖🏖🏖🏖🏖🏖🏖🏖🏖🏖🌴🌴🌴🌴🌴🌴🌴🌴🏖🏖🏖🏖🏖🌊🌊🏖🏖🏖🏖🏖🏖🏖🏖🏖🏖🏖🏖🌴🌴🌴🌴🌴🌴🌴🌴🌴🌴🌾🌾🌲🌲
🌴🌴🏢🌲🌲🌲🌲🌲🌲🏔🏔🏔🏔🏔🏔🏔🌲🌲🌲🌲🌲🏡🏡🏡🌲🏡🏡🏡🏡🏡🌲🌾🌴🌴🌴🌴🌴🌴🌴🌴🏖🏖🏖🏖🏖🌊🌊🌊🌊🌊🏖🏖🏖🏖🏖🏖🏖🏖🏖🏖🏖🏖🏖🏖🏖🏖🏖🏖🏖🏖🌊🌊🌊🌊🌊🏖🏖🏖🏖🏖🏖🏖🏖🏖🏖🏖🏖🌴🌴🌴🌴🌴🌴🌴🌴🌴🌾🌾🌾🌲
🌴🌴🏢🌲🌲🌲🌲🌲🌲🌲🏔🏔🏔🏔🏔🏔🏔🌲🌲🌲🌲🏡🏡🏡🏡🏡🏡🏡🏡🌲🌾🌾🌴🌴🌴🌴🌴🌴🏖🏖🏖🏖🏖🌊🌊🌊🌊🌊🌊🌊🌊🌊🌊🌊🌊🏖🏖🏖🏖🏖🏖🏖🏖🏖🌊🌊🌊🌊🌊🌊🌊🌊🌊🌊🌊🌊🏖🏖🏖🏖🏖🌊🌊🌊🌊🌊🏖🏖🌴🌴🌴🌴🌴🌴🌴🌴🌴🌾🌾🌾
🌴🌴🏢🌲🌲🌲🌲🌲🌲🌲🏔🏔🏔🏔🏔🏔🏔🏔🌲🌲🌲🏡🏡🌲🌲🌲🌲🌲🌲🌾🌾🌴🌴🌴🌴🌴🏖🏖🌊🌊🌊🌊🌊🌊🌊🌊🌊🌊🌊🌊🌊🌊🌊🌊🌊🏖🏖🏖🏖🏖🌊🌊🌊🌊🌊🌊🌊🌊🌊🌊🌊🌊🌊🌊🌊🌊🏖🏖🏖🏖🏖🌊🌊🌊🌊🌊🌊🏖🌴🌴🌴🌴🌴🌴🌴🌴🌴🌴🌾🌾
🌴🌴🏢🌲🌲🌲🌲🌲🌲🌲🏔🏔🏔🏔🏔🏔🏔🌲🌲🌲🌲🏡🌲🌲🌲🌾🌾🌾🌾🌴🌴🌴🌴🌴🏖🏖🌊🌊🌊🌊🌊🌊🌊🌊🌊🌊🌊🌊🌊🌊🌊🌊🌊🌊🌊🏖🏖🏖🏖🏖🌊🌊🌊🌊🌊🌊🌊🌊🌊🌊🌊🌊🌊🌊🌊🌊🌊🏖🏖🏖🌊🌊🌊🌊🌊🌊🌊🏖🏖🌴🌴🌴🌴🌴🌴🌴🌴🌴🌾🌾
🌴🌴🌴🏢🌲🌲🌲🌲🌲🌲🏔🏔🏔🏔🏔🏔🌲🌲🌲🌲🌲🏡🌲🌲🌾🌾🌾🌴🌴🌴🌴🌴🌴🏖🏖🌊🌊🌊🌊🌊🌊🌊🌊🌊🌊🌊🌊🌊🌊🌊🌊🌊🌊🌊🌊🌊🏖🏖🏖🏖🌊🌊🌊🌊🌊🌊🌊🌊🌊🌊🌊🌊🌊🌊🌊🌊🌊🌊🌊🌊🌊🌊🌊🌊🌊🌊🌊🌊🏖🏖🌴🌴🌴🌴🌴🌴🌴🌴🌾🌲
🌴🌴🌴🏢🌲🌲🌲🌲🌲🌲🏔🏔🏔🏔🏔🌲🌲🌲🌲🌲🏡🏡🌲🌲🌾🌾🌴🌴🌴🌴🌴🌴🏖🏖🌊🌊🌊🌊🌊🌊🌊🌊🌊🌊🌊🌊🌊🌊🌊🌊🌊🌊🌊🌊🌊🌊🌊🏖🏖🏖🌊🌊🌊🌊🌊🌊🌊🌊🌊🌊🌊🌊🌊🌊🌊🌊🌊🌊🌊🌊🌊🌊🌊🌊🌊🌊🌊🌊🌊🏖🏖🌴🌴🌴🌴🌴🌴🌾🌾🌲
🌴🌴🌴🏢🏢🌲🌲🌲🌲🌲🏔🏔🏔🏔🏔🌲🌲🌲🌲🌲🏡🏡🌲🌲🌾🌴🌴🌴🌴🌴🌴🏖🏖🌊🌊🌊🌊🌊🌊🌊🌊🌊🌊🌊🌊🌊🌊🌊🌊🌊🌊🌊🌊🌊🌊🌊🌊🌊🌊🌊🌊🌊🌊🌊🌊🌊🌊🌊🌊🌊🌊🌊🌊🌊🌊🌊🌊🌊🌊🌊🌊🌊🌊🌊🌊🌊🌊🌊🌊🏖🏖🏖🌴🌴🌴🌴🌴🌾🌾🌲
🌴🌴🌴🌴🏢🌲🌲🌲🌲🌲🏔🏔🏔🏔🏔🌲🌲🌲🌲🌲🏡🏡🏡🌲🌾🌴🌴🌴🌴🌴🌴🏖🏖🌊🌊🌊🌊🌊🌊🌊🌊🌊🌊🌊🌊🌊🌊🌊🌊🌊🌊🌊🌊🌊🌊🌊🌊🌊🌊🌊🌊🌊🌊🌊🌊🌊🌊🌊🌊🌊🌊🌊🌊🌊🌊🌊🌊🌊🌊🌊🌊🌊🌊🌊🌊🌊🌊🌊🌊🌊🏖🏖🌴🌴🌴🌴🌴🌾🌲🌲
🌴🌴🌴🌴🏢🌲🌲🌲🌲🌲🏔🏔🏔🏔🏔🏔🌲🌲🌲🌲🌲🏡🏡🌲🌾🌴🌴🌴🌴🌴🌴🏖🏖🌊🌊🌊🌊🌊🌊🌊🌊🌊🌊🌊🌊🌊🌊🌊🌊🌊🌊🌊🌊🌊🌊🌊🌊🌊🌊🌊🌊🌊🌊🌊🌊🌊🌊🌊🌊🌊🌊🌊🌊🌊🌊🌊🌊🌊🌊🌊🌊🌊🌊🌊🌊🌊🌊🌊🌊🌊🏖🏖🌴🌴🌴🌴🌾🌾🌲🏡
🌴🌴🌴🌴🏢🌲🌲🌲🌲🏔🏔🏔🏔🏔🏔🏔🌲🌲🌲🌲🌲🏡🏡🌲🌾🌴🌴🌴🌴🌴🌴🏖🏖🌊🌊🌊🌊🌊🌊🌊🌊🌊🌊🌊🌊🌊🌊🌊🌊🌊🌊🌊🌊🌊🌊🌊🌊🌊🌊🌊🌊🌊🌊🌊🌊🌊🌊🌊🌊🌊🌊🌊🌊🌊🌊🌊🌊🌊🌊🌊🌊🌊🌊🌊🌊🌊🌊🌊🌊🌊🏖🌴🌴🌴🌴🌾🌾🌲🌲🏡
🌴🌴🌴🌴🏢🌲🌲🌲🌲🏔🏔🏔🏔🏔🏔🏔🏔🌲🌲🌲🌲🌲🏡🌲🌲🌾🌴🌴🌴🌴🌴🏖🌊🌊🌊🌊🌊🌊🌊🌊🌊🌊🌊🌊🌊🌊🌊🌊🌊🌊🌊🌊🌊🌊🌊🏖🌊🌊🌊🌊🌊🌊🌊🌊🌊🌊🌊🌊🌊🌊🌊🌊🌊🌊🌊🌊🌊🌊🌊🌊🌊🌊🌊🌊🌊🌊🌊🌊🌊🏖🏖🌴🌴🌴🌾🌾🌲🌲🏡🏡
🌴🏢🏢🏢🌲🌲🌲🌲🏔🏔🏔🏔🏔🏔🏔🏔🏔🏔🌲🌲🌲🌲🏡🏡🌲🌾🌴🌴🌴🌴🌴🏖🌊🌊🌊🌊🌊🌊🌊🌊🌊🌊🌊🌊🌊🌊🌊🌊🏖🏖🏖🌊🌊🏖🏖🏖🏖🏖🌊🌊🌊🌊🌊🌊🌊🌊🌊🌊🌊🌊🌊🌊🌊🌊🌊🌊🌊🌊🌊🌊🌊🌊🌊🌊🌊🌊🌊🏖🏖🏖🌴🌴🌴🌴🌾🌲🌲🏡🏡🏡
🏢🏢🌲🌲🌲🌲🌲🏔🏔🏔🏔🏔🌲🌲🌲🌲🏔🏔🌲🌲🌲🌲🏡🏡🌲🌾🌾🌴🌴🌴🌴🏖🌊🌊🌊🌊🌊🌊🌊🌊🌊🌊🌊🌊🌊🌊🌊🏖🏖🏖🏖🏖🏖🏖🏖🏖🏖🏖🏖🏖🌊🏖🏖🏖🌊🌊🌊🌊🌊🌊🌊🌊🌊🌊🌊🌊🌊🌊🌊🌊🌊🌊🌊🏖🏖🏖🏖🏖🌴🌴🌴🌴🌴🌴🌾🌲🌲🏡🏡🌲
🏢🌲🌲🌲🌲🌲🏔🏔🌲🌲🌲🌲🌲🌲🌲🌲🏔🏔🌲🌲🌲🌲🏡🏡🌲🌲🌾🌴🌴🌴🌴🌴🏖🌊🌊🌊🌊🌊🌊🌊🌊🏖🏖🏖🏖🌊🏖🏖🏖🏖🏖🏖🏖🏖🌴🌴🏖🏖🏖🏖🏖🏖🏖🏖🏖🏖🏖🏖🏖🏖🏖🌊🌊🌊🌊🌊🌊🌊🌊🌊🌊🌊🌊🏖🏖🌴🌴🌴🌴🌴🌴🌴🌴🌾🌾🌲🏡🏡🏡🌲
🌲🌲🌲🌲🌲🏔🏔🌲🌲🌲🌲🌲🌲🌲🌲🌲🏔🏔🏔🌲🌲🌲🏡🏡🌲🌲🌾🌴🌴🌴🌴🌴🏖🌊🌊🌊🌊🌊🌊🌊🌊🏖🏖🏖🏖🏖🏖🏖🏖🏖🏖🏖🏖🏖🌴🌴🌴🏖🏖🏖🌴🌴🌴🌴🌴🌴🏖🏖🏖🏖🏖🏖🌊🌊🌊🌊🌊🌊🌊🌊🌊🌊🌊🏖🌴🌴🌴🌴🌴🌴🌴🌴🌾🌾🌲🌲🏡🏡🏡🌲
🌲🌲🌲🌲🏔🏔🌲🌲🌲🌲🌲🌲🌲🌲🌲🌲🏔🏔🏔🌲🌲🌲🌲🏡🌲🌲🌾🌴🌴🌴🌴🌴🌴🏖🌊🌊🌊🌊🌊🌊🏖🏖🏖🏖🏖🏖🏖🏖🏖🏖🏖🏖🏖🌴🌴🌴🌴🌴🌴🌴🌴🌴🌴🌴🌴🌴🌴🌴🌴🌴🏖🏖🌊🌊🌊🌊🌊🌊🌊🌊🌊🌊🏖🌴🌴🌴🌴🌴🌴🌴🌾🌾🌾🌾🌲🌲🏡🏡🏡🌲
🌲🌲🌲🏔🏔🌲🌲🌲🌲🌲🌲🌲🌲🌲🌲🌲🏔🏔🏔🌲🌲🌲🌲🏡🌲🌲🌾🌾🌴🌴🌴🌴🌴🏖🌊🌊🌊🌊🌊🌊🏖🏖🌴🌴🌴🌴🌴🌴🏖🏖🏖🏖🌴🌴🌴🌴🌴🌴🌴🌴🌴🌴🌴🌴🌴🌴🌴🌴🌴🌴🌴🏖🏖🌊🌊🌊🌊🌊🌊🌊🌊🌊🏖🌴🌴🌴🌴🌴🌴🌾🌾🌾🌾🌲🌲🌲🏡🏡🏡🌲
🌲🌲🏔🏔🌲🌲🌲🌲🌲🌲🌲🌲🌲🌲🌲🌲🏔🏔🏔🌲🌲🌲🏡🏡🏡🌲🌾🌾🌴🌴🌴🌴🌴🏖🏖🌊🌊🌊🌊🌊🏖🏖🌴🌴🌴🌴🌴🏖🏖🏖🏖🌴🌴🌴🌴🌴🌴🌴🌴🌴🌴🌴🌴🌴🌴🌴🌴🌴🌴🌴🌴🌴🏖🌊🌊🌊🌊🌊🌊🌊🌊🌊🏖🌴🌴🌴🌴🌴🌾🌾🌾🌾🌾🌲🌲🌲🏡🏡🌲🌲
🌲🏔🏔🌲🌲🌲🌲🌲🌲🌲🌲🌲🌲🌲🌲🌲🌲🏔🏔🌲🌲🌲🏡🏡🏡🌲🌲🌾🌴🌴🌴🌴🌴🏖🏖🌊🌊🌊🌊🌊🏖🏖🌴🌴🌴🌴🌴🏖🏖🌴🌴🌴🌴🌴🌴🌴🌴🌴🌴🌴🌴🌴🌴🏢🏢🏢🏢🌴🌴🌴🌴🌴🏖🏖🌊🌊🌊🌊🌊🌊🌊🌊🏖🌴🌴🌴🌴🌴🌾🌾🌾🌲🌲🌲🌲🏡🏡🏡🌲🌲
🌲🏔🏔🌲🌲🌲🌲🌲🌲🌲🌲🌲🌲🌲🌲🌲🌲🏔🏔🌲🌲🌲🏡🏡🏡🌲🌲🌾🌴🌴🌴🌴🌴🏖🏖🌊🌊🌊🌊🌊🏖🏖🌴🌴🌴🌴🏖🏖🏖🌴🌴🌴🌴🌴🌴🌴🌴🌴🌴🌴🌴🌴🌴🏢🏢🏢🏢🏢🌴🌴🌴🌴🌴🏖🏖🏖🌊🌊🌊🌊🌊🌊🏖🌴🌴🌴🌴🌴🌾🌾🌲🌲🌲🌲🏡🏡🏡🌲🌲🌲
🌲🏔🏔🌲🌲🌲🌲🌲🌲🌲🌲🌲🌲🌲🌲🌲🌲🌲🌲🌲🌲🌲🏡🏡🌲🌲🌲🌾🌴🌴🌴🌴🏖🏖🌊🌊🌊🌊🌊🏖🏖🌴🌴🌴🌴🌴🏖🏖🌴🌴🌴🌴🌴🌴🌴🌴🌴🌴🌴🌴🌴🌴🌴🏢🏢🌲🏢🏢🌴🌴🌴🌴🌴🌴🏖🏖🏖🌊🌊🌊🌊🌊🏖🌴🌴🌴🌴🌾🌾🌾🌲🌲🌲🏡🏡🏡🌲🌲🌲🌲
🌲🏔🏔🌲🌲🌲🌲🌲🌲🌲🌲🌲🌲🌲🌲🌲🌲🌲🌲🌲🌲🏡🏡🌲🌲🌲🌾🌾🌴🌴🌴🌴🏖🏖🌊🌊🌊🌊🌊🏖🏖🌴🌴🏖🏖🏖🏖🏖🏖🌴🌴🌴🌴🌴🌴🏖🏖🏖🏖🌴🌴🌴🌴🏢🏢🌲🏢🏢🌴🌴🌴🌴🌴🌴🌴🏖🏖🏖🌊🌊🌊🌊🏖🌴🌴🌴🌴🌾🌾🌾🌲🌲🌲🏡🏡🌲🌲🌲🌲🏔
🌲🏔🏔🌲🌲🌲🌲🌲🌲🌲🌲🌲🌲🌲🌲🌲🌲🌲🌲🌲🌲🏡🏡🌲🌲🌾🌾🌴🌴🌴🌴🌴🏖🏖🌊🌊🌊🌊🌊🏖🏖🌴🏖🏖🏖🏖🏖🏖🏖🌴🌴🌴🏖🏖🏖🌊🌊🌊🏖🏖🌴🌴🌴🏢🏢🏢🏢🏢🌴🌴🌴🌴🌴🌴🌴🏖🏖🏖🌊🌊🌊🌊🌊🌴🌴🌴🌴🌾🌾🌾🌾🌲🌲🏡🏡🌲🌲🌲🏔🏔
🌲🏔🏔🌲🌲🌲🌲🌲🌲🌲🌲🌲🌲🌲🌲🌲🌲🌲🌲🌲🌲🏡🌲🌲🌾🌾🌾🌴🌴🌴🌴🌴🏖🏖🌊🌊🌊🌊🌊🏖🏖🏖🏖🏖🏖🏖🏖🏖🏖🏖🏖🏖🏖🌊🌊🌊🌊🌊🌊🏖🌴🌴🌴🏢🏢🏢🏢🌴🌴🌴🌴🌴🌴🌴🌴🏖🏖🏖🌊🌊🌊🌊🏖🌴🌴🌴🌴🌴🌴🌾🌾🌾🌲🏡🏡🌲🌲🌲🏔🏔
🏔🏔🏔🌲🌲🌲🌲🌲🌲🌲🌲🌲🌲🌲🌲🌲🌲🌲🌲🌲🌲🏡🌲🌲🌾🌾🌾🌴🌴🌴🌴🌴🏖🏖🌊🌊🌊🌊🌊🌊🏖🏖🏖🏖🏖🏖🏖🏖🏖🏖🏖🌊🌊🌊🌊🌊🌊🌊🌊🏖🌴🌴🌴🌴🌴🌴🌴🌴🌴🌴🌴🌴🌴🌴🌴🏖🏖🏖🌊🌊🌊🌊🏖🌴🌴🌴🌴🌴🌴🌴🌾🌾🌾🌲🏡🌲🌲🌲🌲🏔
🏔🏔🏔🌲🌲🌲🌲🌲🏡🏡🏡🏡🌲🌲🌲🌲🌲🌲🌲🌲🌲🏡🌲🌲🌲🌾🌾🌴🌴🌴🌴🌴🏖🏖🌊🌊🌊🌊🌊🌊🏖🏖🏖🏖🏖🏖🏖🏖🏖🏖🌊🌊🌊🌊🌊🌊🌊🌊🌊🌊🏖🌴🌴🌴🌴🌴🌴🌴🌴🌴🌴🌴🌴🌴🏖🏖🏖🌊🌊🌊🌊🌊🏖🌴🌴🌴🌴🌴🌴🌴🌴🌾🌾🌲🏡🏡🌲🌲🌲🏔
