🏔🏔🏔🏔🏔🏔🏔🏔🌲🌲🌲🌲🌲🌲🌲🌲🏔🌲🏡🌲🌲🏡🌲🏔🏔🏔🏔🏔🌲🌲🌲🌲🏔🌲🌲🏡🌾🌴🏖🌊🌊🏖🌴🌲🏡🌲🌲🏔🏔🏔🏔🏔🌲🌲🌲🏔🌲🏢🌴🌴🌴🌴🏢🌲🌲🏔🌲🏡🌲🌾🌴🌴🌊🌊🏖🌴🏢🌲🌲🌲🌲🌲🏢🌴🌊🏖🌴🌴🌴🌴🌴🌲🌲🌲🌲🏔🏔🏔🏔🏔
🌴🌴🌴🌴🌴🌴🌴🌴🌴🏢🌲🌲🌲🏢🌴🌴🏢🌲🏔🌲🌲🌲🌲🌲🌲🌲🌲🌲🏢🌴🌴🌴🏢🌲🌲🌲🏡🌴🌴🏖🌊🏖🌴🌾🏡🌲🌲🏔🏔🏔🏔🏔🌲🌲🏔🌲🌲🌴🏖🌊🌊🌊🌴🌴🏢🌲🌲🌲🌲🌲🌲🌴🌊🌊🌴🌴🌲🌲🏔🌲🌲🏔🌲🏢🏖🌊🏖🌴🌴🌴🌴🌾🏡🌲🌲🏔🌲🌲🌲🏡
🌊🌊🌊🌊🌊🌊🌊🌊🌊🌊🌴🌴🌴🌴🏖🏖🌴🌴🌲🌲🌲🌲🌲🏢🌴🌴🌴🌴🌴🌊🌊🌊🏖🌴🏢🌲🌲🏡🌾🌴🌴🌴🌴🌴🌲🏡🌲🏔🌲🌲🌲🌲🌲🏔🌲🌲🏢🌴🌊🌊🏖🌊🌊🌊🌴🌴🌴🏢🌲🌲🌲🌾🌴🌊🌴🏢🌲🏔🌲🌲🌲🌲🌲🌲🌴🏖🌊🏖🏖🌴🌴🌾🏡🌲🏔🏔🌲🌲🌲🌾
🏖🏖🏖🏖🌴🌴🌴🌴🌴🌴🏖🌊🌊🌊🌊🌊🌊🌊🌴🌴🏢🏢🌴🌴🌴🌴🌴🌴🌊🌊🏖🌊🌊🏖🌴🌲🌲🌲🌲🌲🌾🌴🌴🌾🌾🏡🌲🏔🌲🌲🌲🌲🌲🌲🌲🌲🌴🏖🌊🌴🌴🌴🌴🌊🌊🏖🌴🌴🌴🌲🏔🏡🌴🌊🏖🌴🌲🌲🌲🌲🏡🏡🏡🌲🌲🌴🌊🌊🌊🌴🌴🌾🏡🌲🌲🏔🌲🌲🌲🌴
🌴🌴🌴🌴🌴🌴🌾🏡🏡🏡🌲🌴🌴🌴🌴🌴🌴🌴🏖🌊🏖🌴🏖🌊🌊🌊🏖🌊🌊🌊🌴🌴🌊🌊🌴🏢🌲🌲🏔🌲🌲🌲🌲🌲🏡🏡🌲🌲🏢🌴🌴🌴🌴🏢🏢🌴🌴🌊🌊🌴🌾🌾🌴🏖🌊🌊🏖🌴🌴🌲🌲🌲🌾🏖🌊🌴🏢🌲🌲🏔🌲🌲🏡🌲🌲🌲🌴🌊🌊🏖🌴🌴🌾🌲🌲🌲🌲🌲🏡🌾
🌾🌾🌴🌴🌴🌾🌲🌲🏔🌲🏔🌲🌲🏡🏡🌲🌲🌲🌲🌴🌊🌊🌊🌊🌊🌊🌊🌊🌊🏖🌴🌴🏖🌊🏖🌴🏢🌲🌲🌲🌲🌲🏔🌲🌲🌲🌲🌲🌴🌴🌴🌴🌴🌴🌴🌴🏖🌊🌴🌾🌲🌲🌾🌴🌊🌊🏖🌴🌴🌲🏔🌲🌲🌴🌊🌊🌴🌴🏢🌲🌲🌲🌲🌲🌲🏔🌲🌴🏖🌊🌊🌴🌴🌴🌾🏡🌲🌲🌲🌲
🏡🏡🌲🌾🌾🌲🏡🌲🌲🌲🌲🌲🌲🌲🌲🌲🌲🌲🏔🏡🌴🌴🌴🌴🌴🏖🌊🌊🏖🌴🌴🌴🌴🏖🌊🏖🌴🌴🏢🌲🌲🌲🌲🌲🌲🌲🌲🏢🌴🌴🌴🌴🌴🌴🌴🏖🌊🏖🌴🌲🌲🏡🌾🌴🌊🌊🏖🌴🏢🌲🌲🌲🌲🌴🏖🌊🏖🌴🌴🌴🌴🏢🌲🏔🌲🌲🌲🏢🌴🏖🌊🌊🌊🏖🌴🌾🌲🏔🏔🏔
🌲🌲🌲🌲🌲🌲🏡🌲🌲🏢🌴🏢🏢🏢🏢🌴🌴🌴🏢🌲🌲🏡🌲🌲🌲🌾🌴🌴🌴🌴🌴🌾🌴🌴🏖🌊🏖🌴🌴🌴🌴🌴🌴🏢🏢🏢🏢🌴🌴🌴🌴🌴🌴🌴🏖🌊🌊🌴🌾🏡🌲🌲🌲🌴🌊🌊🏖🌴🌲🌲🌲🏡🌲🌴🌴🌊🌊🌊🌊🌊🌊🌴🌴🌲🏔🌲🏔🌲🏢🌴🏖🌊🌊🌊🏖🌴🏡🏔🌲🌲
🏔🏔🌲🌲🏡🏡🌲🏔🌲🏢🌴🌴🏢🌴🌴🌴🏖🏖🌴🌴🌲🌲🌲🏔🏔🌲🏡🌲🌾🌾🌲🏡🏡🌲🌴🏖🌊🌊🌴🌴🌴🌴🌴🌴🌴🌴🌴🌴🌴🌴🌴🌴🌴🌴🌊🌊🏖🌴🌲🌲🌲🌲🌲🌴🌊🌊🌴🌴🌲🏔🌲🌲🌾🌴🌴🌊🌊🌊🌊🌊🌊🌊🏖🌴🌲🏔🏔🌲🏢🌴🌴🏖🌊🌊🌊🌴🌲🏔🌲🌲
🌲🌲🌲🏔🌲🌲🌲🏔🌲🌲🌲🌲🌲🏢🌴🌴🌊🌊🌊🏖🌴🌴🌴🌴🏢🌲🌲🏔🌲🌲🌲🏔🌲🏔🌲🌲🌴🌊🌊🏖🏖🏖🌊🌊🌊🌊🌊🌴🌴🌴🌴🌴🌴🌴🌊🌊🌊🌴🌲🌲🌲🏡🌾🌴🌊🌊🏖🌴🌲🌲🌲🌲🌾🌴🏖🌊🌊🌊🌊🌊🏖🌊🌊🏖🌴🌲🌲🌲🏢🌴🏖🌊🌊🌊🌊🌴🌾🌲🏔🌲
🌲🌲🌲🌲🏔🌲🌲🌲🏔🌲🌲🌲🌲🌲🌴🌴🌊🌊🌊🌊🌊🏖🏖🏖🏖🌴🌴🏢🌲🌲🌲🏢🌴🌴🏢🌲🌲🌴🌴🌊🌊🌊🌊🌊🌊🌊🌊🌊🏖🏖🏖🏖🏖🏖🏖🌊🌊🌴🌾🏡🌲🌲🌴🌴🌊🌊🏖🌴🏢🌲🌲🏡🌾🌴🏖🌊🌊🌊🌊🌊🏖🏖🌊🌊🏖🌴🏢🌴🌴🏖🌊🌊🌊🌊🏖🌴🌴🌾🏡🌲
🌲🌲🌲🌲🌲🌲🌲🌲🌲🌲🌲🌲🏔🌲🏢🏖🌊🌊🏖🌊🌊🌊🌊🌊🌊🌊🏖🌴🌴🌴🌴🏖🌊🌊🌊🌴🌲🌲🌲🌴🌊🌊🌊🌊🌊🏖🏖🌊🌊🌊🌊🌊🌊🌊🏖🏖🌊🏖🌴🌲🏡🌲🌴🌴🌊🌊🌊🌴🌴🌲🏔🌲🌾🌴🌴🏖🌊🌊🌊🌊🌊🏖🏖🌊🌊🏖🌴🌴🌊🌊🌊🏖🏖🏖🌴🌴🌴🌴🌾🏡
🌲🌲🌲🌲🌲🌲🌲🏡🏡🏡🌲🌲🏔🌲🌴🏖🌊🏖🏖🏖🌊🌊🌊🌊🌊🌊🌊🏖🌴🏖🌊🌊🏖🌴🏖🌊🏖🏢🌲🏡🌴🌴🏖🏖🌴🌴🌴🌴🏖🌊🌊🌊🌊🌊🏖🏖🌊🌊🌴🌲🏡🌲🌴🌴🌊🌊🌊🌴🌴🌲🌲🌲🏡🌾🌴🌴🏖🌊🌊🌊🌊🌴🌴🌴🌊🌊🌊🌊🌊🌊🌴🌴🌴🌴🌴🌴🌴🌴🌴🌾
🌲🌲🌲🌲🏔🌲🏡🌲🌲🏡🌲🌲🌲🌲🌴🏖🌊🏖🌴🏖🏖🌊🌊🌊🌊🌊🌊🌊🌊🌊🌊🏖🌴🌴🌴🌴🌊🏖🌴🌲🌲🌾🌴🌴🌾🌲🌲🌴🌴🌴🌴🌴🌊🌊🌊🌊🌊🏖🌴🌲🏡🌲🌴🌴🏖🌊🌊🏖🌴🌲🌲🌲🌲🏡🌲🌾🌴🌴🏖🌊🏖🌴🌴🌴🌴🌊🌊🌊🌊🌴🌴🌴🌴🌴🌴🏖🏖🏖🌴🌾
🌲🏢🏢🌲🏔🏡🌾🌴🌴🌾🏡🌲🌲🌲🌴🏖🌊🏖🌴🌴🏖🌊🌊🌊🌊🌊🌊🌊🌊🌊🏖🌴🌾🌲🌲🌾🌴🌊🏖🌴🌲🌲🌲🌲🌲🌲🌲🌲🌲🌾🌴🌴🌴🌊🌊🌊🌊🏖🌴🌲🏡🌲🌾🌴🌴🌊🌊🌊🌴🏢🌲🌲🌲🌲🏡🌲🌾🌴🌴🌴🌴🌴🌴🌴🌴🌴🏖🏖🌴🌴🌴🌴🌴🌴🏖🏖🌊🏖🌴🌴
🌲🏢🏢🌲🌲🌲🌴🌴🌴🌴🌲🌲🏔🌲🌲🌴🌊🌊🏖🌴🌴🏖🌊🌊🌊🌊🌊🌊🌊🏖🌴🌴🌲🌲🏡🌲🌴🏖🌊🏖🌴🌲🌲🌲🌲🌲🌲🌲🌲🌲🌲🏡🌾🌴🌊🌊🏖🌴🌴🌲🌲🌲🌾🌾🌴🌴🏖🌊🌊🌴🌴🌲🌲🏔🌲🏡🌾🌴🌴🌴🌴🌴🌾🌾🌴🌴🌴🌴🌴🌾🌾🌴🌴🌴🏖🏖🏖🏖🏖🌴
🌲🏢🏢🌲🏔🏡🌾🌴🌴🌴🌾🏡🌲🏔🌲🌴🏖🌊🌊🏖🏖🏖🌊🌊🌊🌊🌊🏖🌴🌴🌴🌾🌲🌲🌲🌲🌴🌴🌊🌊🌴🌴🌴🌴🌴🌴🌴🌴🌴🏢🌲🏔🏡🌴🌴🌴🌴🌴🌾🌲🌲🌲🌲🏡🏡🏡🌾🌴🏖🌊🏖🌴🌲🏔🌲🏡🌾🌴🌴🌴🌾🌾🌾🌾🌾🌾🌾🌲🌲🌲🌲🌴🌴🌴🌴🌴🏖🏖🏖🌊
🌲🏢🌴🌲🌲🌲🌲🌾🌾🌾🌾🌲🏡🌲🏔🌲🌴🏖🌊🌊🌊🌊🌊🌊🌊🌊🌊🏖🌴🌴🌾🌾🌲🌲🌲🌲🌾🌴🏖🌊🌊🌊🌊🌊🌊🌊🌊🌊🌊🌴🌴🌲🌲🌲🌴🌴🌾🌲🌲🏡🌲🏡🌲🌲🏔🏔🌲🏡🌾🌴🌊🏖🌴🌲🌲🏡🌾🌾🌾🌾🌾🌾🌴🌴🌴🌾🌲🏡🏡🏡🌲🌴🌴🌴🌴🌴🌴🏖🌊🌊
🌲🏢🌴🏢🌲🏔🌲🌲🏡🌲🌲🌲🏡🌲🌲🌲🌲🌴🌴🌴🏖🏖🏖🏖🏖🌊🌊🌊🏖🌴🌾🌾🌲🌲🏡🏡🏡🌲🌴🌴🌊🌊🌊🌊🌊🌊🌊🌊🌊🌊🌴🌴🌲🌲🏡🏡🏡🌲🌲🌲🌲🌲🏔🌲🏢🏢🌲🌲🌲🌾🌴🌊🏖🌴🌲🌲🏡🏡🌲🌲🌲🌾🌴🌴🌴🌾🌲🏡🏡🏡🌲🌴🌴🌴🌴🌴🌴🌴🏖🌊
🌲🌲🌴🌴🏢🌲🌲🏔🌲🌲🏡🏡🌲🌲🌲🏔🌲🌲🌲🌲🌲🌲🌲🏢🏢🌴🌴🏖🌊🌴🌴🌾🌲🏡🏡🌲🌲🌲🌲🌾🌴🏖🌊🌊🌊🌊🏖🌴🏖🌊🌊🌴🌲🌲🏔🏔🏔🏔🌲🏔🏔🌲🌲🌴🌴🌴🌴🏢🌲🌲🌾🌴🌊🌊🌴🌲🌲🌲🌲🌲🌲🌾🌴🌴🌴🌴🌾🌲🏡🏡🌲🌾🌴🌴🌴🌴🌴🌴🌴🏖
🏔🌲🏢🌴🏢🌲🌲🌲🏔🌲🌲🌲🌲🌲🌲🌲🌲🌲🌲🌲🌲🌲🌲🌲🏔🌲🌲🌴🌊🌊🌴🌴🌾🏡🌲🏔🌲🌲🌲🏡🌾🌴🏖🌊🌊🌊🏖🌴🌴🌊🌊🏖🌴🌲🌲🌲🌲🌲🌲🌲🌲🏢🌴🌊🌊🌊🌊🌴🌴🌲🌲🌲🌴🏖🌊🌴🌴🌲🌲🏔🌲🌲🌴🌴🌴🌴🌴🌾🌲🌲🌲🌲🌾🌾🌾🌾🌾🌴🌴🌴
🌲🌲🌲🏢🏢🏢🌲🌲🏔🌲🏡🌲🌲🌲🌲🌲🌾🌴🌴🌴🌴🌴🌾🌲🏡🌲🏔🌲🌴🌊🏖🌴🌴🌲🌲🌲🌲🌲🌲🏔🌲🌴🌊🌊🌊🌊🏖🌴🌴🏖🌊🌊🌴🌴🏢🏢🏢🏢🌴🌴🌴🌴🌊🏖🌴🌴🌴🌊🌊🌴🌲🌲🌲🌴🏖🌊🏖🌴🏢🌲🏔🏡🌲🌴🌴🌴🌴🌴🌾🌲🌲🌲🌲🌲🌾🌾🌾🌾🌾🌾
🌲🌲🌲🌲🏢🏢🌲🌲🌲🌲🌾🌴🌴🌴🌴🌴🌴🏖🌊🌊🌊🏖🌴🌴🌲🏡🌲🌲🏢🏖🌊🏖🌴🌾🌲🌲🌲🏢🌲🌲🏡🌴🌊🌊🌊🌊🏖🌴🌴🏖🏖🌊🌊🏖🌴🌴🌴🌴🌴🌴🌊🌊🌴🌾🏡🌲🏡🌾🏖🌊🌴🌲🌲🌲🌴🌴🌊🌊🌴🌴🌲🏔🌲🌲🌴🌴🌴🌴🌾🌲🏡🌲🌲🏡🌲🌴🌴🌾🌲🌲
🏡🌲🌲🌲🌲🌲🌲🌲🌲🌴🌴🏖🏖🏖🏖🏖🏖🌊🌊🌊🌊🌊🌴🌴🌲🏡🌲🏔🌲🌴🌊🌊🌴🌴🏡🏔🌲🌲🌲🏔🏡🌴🏖🌊🏖🌴🌴🌴🌴🌴🌴🌴🏖🌊🏖🌴🌴🌴🏖🌊🌊🏖🌴🏡🏔🌲🌲🌲🌲🌴🌊🌴🌲🌲🏡🌾🌴🏖🌊🌴🏢🌲🏔🌲🌲🌾🌾🌲🏡🌲🏔🌲🏔🌲🏡🌾🌾🌾🌲🏡
🏡🏡🌲🏔🌲🌲🏔🏡🌴🌴🌊🌊🌊🌊🌊🌊🌊🌊🌊🌊🌊🌊🌴🌾🌲🏡🌲🏔🌲🌴🌊🏖🌴🌴🌲🌲🏔🌲🏔🌲🌲🌴🌴🌴🌴🌴🌴🌴🌴🌴🌴🌴🌴🌊🌊🏖🏖🌊🌊🌊🌊🌴🌾🌲🌲🏢🏢🌲🏔🏡🌴🌊🌴🌲🏔🌲🏡🌴🏖🌊🌴🌲🌲🌲🌲🌲🌲🌲🏔🌲🌲🏢🌲🌲🌲🌲🌲🌲🏡🏡
🏡🏡🌲🏔🌲🌲🌲🌲🌴🏖🌊🌊🌊🌊🌊🌊🌊🌊🌊🌊🌊🌊🌴🌾🌲🏡🌲🏔🌲🌴🌊🏖🌴🌴🌾🏡🌲🌲🌲🏡🌾🌴🌴🌴🌴🌴🌴🌴🌴🌴🌴🌴🌴🏖🌊🌊🌊🌊🌊🌊🏖🌴🌾🌲🌲🌴🌴🌴🌲🌲🌾🏖🌊🌴🌴🌲🌲🌲🌾🌊🏖🌴🌲🌲🏔🏔🌲🌲🌲🌴🌴🌴🌴🏢🌲🌲🌲🌲🌲🌲
🏡🏡🌲🏔🌲🏔🌲🌾🌴🌊🌊🌊🌊🌊🌊🌊🌊🌊🌊🌊🌊🌊🌴🌾🌲🏡🏡🏔🌲🏖🌊🌴🌴🌴🌾🌲🌲🏡🌲🌾🌴🌴🌴🌴🌾🌾🌾🌴🌴🌴🌴🌴🌴🏖🌊🌊🌊🏖🌴🌴🌴🌴🌾🌲🌲🌴🌴🌴🏢🌲🌲🌴🏖🌊🌊🏖🌴🌲🌲🌴🌊🌴🏢🌲🌲🌲🏢🌴🌴🏖🌊🌊🏖🌴🏢🌲🏔🌲🌲🌲
🏡🌲🌲🏔🏔🌲🌲🌴🌊🌊🌊🌊🏖🌴🌴🌴🏖🏖🌊🌊🌊🏖🌴🌴🌾🌲🌲🌲🌲🌴🌊🌴🌴🌴🌾🌴🌴🌾🌴🌴🌴🌴🌴🌴🌾🌲🌾🌴🌴🌴🌴🌴🌴🌴🏖🏖🌴🌴🌴🌴🌴🌴🌲🏔🌲🌴🏖🌴🌴🌲🏔🏡🌴🌴🌴🌊🌊🌴🌲🌲🌊🏖🌴🏢🌴🌴🌴🏖🌊🌊🌊🌊🌊🏖🌴🌲🌲🌲🏔🌲
🏡🌲🌲🌲🌲🏡🌴🏖🌊🌊🏖🏖🌴🌴🏢🌲🏢🌴🌴🏖🌊🌊🌴🌴🌴🌾🌾🏡🏔🏢🌊🌊🌴🌴🌴🌴🌴🌴🌴🌴🌴🌴🌴🌴🌾🌲🌲🌾🌴🌴🏖🏖🏖🌴🌴🌴🌴🌴🌴🌴🌴🌾🌲🌲🌴🏖🌊🏖🌴🏢🌲🌲🏡🌲🌾🌴🏖🌊🏢🌲🌴🌊🏖🌴🏖🌊🌊🌊🌊🌊🌊🌊🌊🌊🏖🌴🏢🌲🌲🌲
🏡🌲🏔🏔🌲🌲🌴🌊🌊🏖🌴🌴🏢🌲🏔🌲🌲🌲🌲🌴🏖🌊🌴🌴🌴🌴🌴🌴🏡🌲🌴🌊🏖🌴🌴🌴🌴🌴🌴🌴🌴🌴🌴🌴🌴🌾🌲🌾🌴🌴🏖🏖🏖🌴🌴🌴🌴🌴🌴🌴🌾🏡🏔🌲🌴🌊🌊🏖🌴🏢🌲🏔🌲🏡🌲🌴🏖🌊🌴🌲🏡🌴🌊🌊🌊🏖🌴🌴🌴🌴🏖🏖🏖🌊🌊🌊🏖🌴🌴🏢
🌲🌲🏔🏔🌲🌲🌴🌊🌊🏖🌴🏢🌲🌲🏡🌾🌾🏡🏔🌲🌴🌊🌊🏖🏖🏖🏖🌴🌴🏡🌲🌴🌊🌴🌴🌴🌴🌴🌴🌴🌴🌴🌴🌴🌴🌴🌾🌲🌾🌴🏖🌊🌊🌴🌴🌴🌴🌴🌴🌴🌾🌲🌲🏢🌴🌊🌊🏖🌴🏢🌲🏔🌲🏡🌲🌴🏖🌊🏖🏢🏔🏡🌴🌴🌴🌴🌾🌾🌴🌴🌴🌴🌴🌴🌴🏖🌊🌊🌊🏖
🌲🌲🏔🌲🌲🏡🌴🏖🌊🏖🌴🌲🏔🌲🌾🌴🌴🌾🌲🌲🏢🏖🌊🌊🌊🌊🌊🌊🏖🌴🌲🏢🏖🌊🌴🌴🌴🌴🌾🌴🌴🌴🌴🌴🌴🌴🌾🌾🌴🌴🏖🌊🌊🏖🌴🌴🌴🌴🌴🌴🌴🏡🏔🌲🌴🏖🏖🌴🌴🌲🌲🌲🌲🌲🌾🌴🌊🌊🏖🌴🌲🏔🏡🌲🌲🏡🌲🌲🏡🌲🌲🌲🏡🏡🏡🌲🌾🌴🌴🏖
🌾🌲🏔🌲🏔🌲🌾🌴🌊🌊🌴🏢🌲🌲🌲🌴🌴🌾🌲🏔🌲🌴🏖🌊🌊🏖🌊🌊🌊🌴🌲🌲🌴🌊🌊🌴🌴🌴🌴🌴🌴🌴🏖🏖🌴🌴🌴🌾🌴🌴🏖🌊🌊🏖🌴🌴🌴🌴🌴🌴🌴🌲🌲🌲🏢🌴🌴🌴🏢🌲🏔🌲🏡🌲🌴🌴🌊🌊🌊🌴🌴🌲🏔🌲🌲🏔🌲🌲🌲🌲🌲🏔🌲🌲🌲🌲🏔🏔🌲🌾
🌾🌲🏔🌲🌲🌲🏡🌾🌴🌊🏖🏢🌲🌲🏡🌲🌲🏡🌲🏔🌲🌴🌴🌴🌴🌴🌴🌴🌊🌊🌴🌲🌲🌴🌊🌊🌊🏖🌴🌴🏖🏖🌊🏖🏖🌴🌴🌴🌴🌴🌊🌊🌊🌊🏖🌴🌴🌴🌴🌴🌴🌾🏡🌲🌲🏢🌴🌴🏢🌲🌲🌲🏡🌲🌴🏖🌊🌊🌊🌊🌴🌴🌲🌲🌲🌲🌲🌲🌲🌲🌲🌲🏢🌴🌴🌴🌴🏢🌲🌲
🌴🏡🌲🌲🌲🏔🌲🏡🌴🏖🌊🌴🌲🌲🏔🌲🌲🏔🌲🌲🌲🌲🏢🏢🏢🌴🌴🌴🌊🌊🌴🌲🌲🌲🌴🌴🏖🌊🌊🌊🌊🌊🌊🌊🌊🌊🌊🏖🏖🌊🌊🌊🌊🌊🌊🏖🌴🌴🌴🌴🌴🌾🌲🌲🏔🌲🏢🏢🏢🌲🌲🏔🌲🏡🌾🌴🌊🌊🌊🌊🌊🏖🌴🌴🏢🏢🌲🌲🌲🌲🌲🌲🌴🌴🌴🌴🏖🌴🌴🌲
🌴🌲🌲🌲🏔🌲🌲🌲🌾🌴🌊🌴🌴🏢🌲🏢🏢🌲🌲🌲🌲🌲🌲🌲🌲🏢🌴🏖🌊🌊🏖🌴🌾🏡🌲🌲🌲🏢🌴🌴🌴🏖🌊🌊🏖🏖🏖🌊🌊🌊🌊🌊🌊🌊🌊🌊🏖🌴🌾🌾🌾🌾🌲🏡🌲🌲🌲🏢🏢🌲🌲🌲🌲🏔🏡🌴🏖🌊🌊🌊🌊🌊🏖🌴🌴🏢🏢🏢🌲🌲🌲🏢🌴🌴🏖🌊🌊🌊🌴🏢
🌴🌴🌲🏡🌲🌲🏡🏡🌾🌴🌊🌴🌴🌴🌴🌴🌴🌴🏢🌲🌲🏔🌲🏔🌲🏢🌴🏖🌊🌊🌊🏖🌴🌴🌴🌲🌲🌲🏔🌲🌲🏢🌴🌴🏢🌲🌲🌲🏢🌴🌴🌴🌴🌴🌴🌊🏖🌴🌲🏡🏡🏡🏡🌲🌲🏔🌲🌲🌲🌲🏢🏢🏢🌲🏔🏡🌴🌴🌴🌴🏖🌊🌊🌴🌴🌴🌴🌴🌴🏢🏢🏢🌴🏖🌊🌊🌊🌊🏖🏢
🌊🌴🌾🌲🌲🌲🌲🌲🌴🌴🌊🏖🏖🏖🏖🌊🏖🌴🏢🌲🌲🌲🌲🏔🌲🏢🌴🌊🌊🌊🌊🌊🌊🌊🌊🌴🌴🌾🌲🏡🌲🌲🏔🌲🌲🏡🏡🏡🌲🏔🌲🌲🌲🌲🏢🌴🌊🌴🌾🏡🌲🌲🌲🌲🏔🏔🌲🌲🌲🌲🏢🌴🌴🌴🌲🏔🏡🌾🌴🌴🌴🌊🌊🏖🌴🌴🌴🌴🌴🌴🌴🌴🌴🌊🌊🌊🏖🌊🌊🌴
🌊🌴🌴🌴🌴🌴🌴🌾🌴🌴🌊🌊🌊🌊🌊🌊🌊🌴🏢🌲🏔🌲🌲🏔🌲🏢🌴🏖🌊🌊🌊🌊🏖🏖🌊🌊🌊🏖🌴🌴🌴🌴🌴🌴🌴🏖🏖🏖🌴🌴🌾🌲🏡🌲🏔🏢🏖🌊🌴🌲🏡🌲🌲🌲🏔🏔🌲🌲🌲🌲🏢🌴🌴🌴🌴🌲🌲🏡🌲🌾🌴🌊🌊🏖🌴🌴🏖🏖🏖🏖🌴🏖🌊🌊🏖🌴🌴🏖🌊🌴
🌊🌊🏖🏖🏖🌴🌴🌴🌴🌴🌊🌊🌊🌊🌊🌊🏖🌴🌲🌲🏔🌲🌲🏔🌲🏢🌴🏖🌊🏖🌴🌴🌴🌴🌴🌴🏖🌊🌊🌊🌊🌊🌊🏖🏖🌴🌴🏖🌊🌊🌊🌊🏖🌴🏡🌲🌴🌊🌴🌾🏡🌲🌲🏔🏔🏔🌲🌲🌲🌲🏢🌴🏖🌊🌴🌴🌲🏔🌲🌲🌴🏖🌊🏖🌴🌴🏖🌊🌊🌊🌊🌊🌊🏖🌴🌴🌴🌴🌊🌴
🌴🌊🌊🌊🌊🌊🏖🌴🌴🌴🌴🌊🌊🌊🌊🌊🌴🏢🌲🏔🌲🌲🏔🌲🌲🏢🌴🌴🌴🌴🏢🌲🌲🏔🌲🌲🏢🌴🌴🌴🌴🏢🌲🌲🌲🌲🌲🏢🌴🌴🌴🌴🏖🌊🌴🌲🏢🏖🏖🌴🌲🏡🌲🌲🌲🏔🌲🌲🌲🏢🌴🏖🌊🌊🌊🏖🌴🌲🌲🌲🌲🌴🌊🌊🏖🌴🏖🏖🏖🏖🌊🌊🌊🌴🌴🌾🌾🌴🌊🌊
🏢🌴🌴🏖🏖🌊🌊🏖🌴🌴🌴🌴🏖🌊🌊🌴🏢🌲🌲🏔🌲🏔🏔🌲🌲🌲🏢🏢🌲🌲🏔🌲🏡🌲🌲🏡🌲🌲🏔🏔🏔🌲🌲🌲🌲🏔🌲🌲🌲🌲🌲🌲🏢🌴🌊🌲🌲🌴🌊🌴🌾🌾🌲🌲🏡🌲🏔🌲🏢🌴🌴🌊🌊🌴🏖🌊🏖🌴🌲🌲🌲🌾🏖🌊🏖🌴🌴🌴🌴🌴🏖🌊🌊🌴🌴🌴🌴🌴🌊🌊
🌲🏢🌴🌴🌴🌊🌊🌴🌴🌾🌾🌴🏖🌊🏖🌴🌲🌲🏔🏔🏔🏔🌲🌲🌲🌲🌲🌲🏔🌲🏡🌾🌴🌴🌴🌴🌴🌴🌴🌾🌴🌴🌴🌴🌲🌲🌲🌲🌲🌲🌲🌲🌲🏢🌊🌴🌲🌲🏖🌊🌴🌴🌴🌴🌴🌲🌲🌲🏢🌴🏖🌊🏖🌴🌴🏖🌊🌴🌴🌲🌲🌲🌴🌊🏖🌴🌴🌴🌴🌴🌴🌊🌊🏖🌴🌴🌴🏖🌊🌊
🌲🏢🏢🌴🌴🌊🌊🌴🌾🌲🌲🌴🏖🌊🌴🌲🌲🏔🏔🌲🌲🏔🌲🌲🌲🏡🏡🏡🌲🌾🌴🌴🌴🏖🌊🌊🌊🌊🌊🌊🌊🌊🌊🏖🌴🏡🏔🌲🌲🌲🌲🏔🏔🌲🌴🌊🌾🏔🌴🌊🌊🌊🏖🏖🌴🌴🌲🌲🏢🌴🏖🌊🏖🌴🌴🏖🌊🏖🌴🌲🌲🌲🌴🌊🏖🌴🌴🌴🌴🌴🌴🏖🌊🌊🌊🌊🌊🌊🌊🌊
🌲🌲🏢🌴🌴🌊🌊🌴🌾🌲🌾🌴🌊🌊🌴🌲🏔🌲🌲🌲🌲🌲🌲🌾🌴🌴🌴🌴🌴🌴🌴🌴🏖🌊🌊🏖🌴🏖🏖🌊🏖🏖🌊🌊🌴🌾🌲🌲🌲🌲🌲🏔🏔🌲🏢🏖🌴🏡🌲🌴🌊🌊🌊🌊🌊🌴🌲🌲🌲🏢🌴🌊🌊🌴🌴🌊🌊🌴🏢🌲🌲🌾🏖🌊🌴🌴🌴🌴🌴🌴🏖🏖🌊🌊🌊🌊🌊🌊🌊🏖
🌲🌲🌲🏢🌴🏖🌊🌴🌴🌾🌾🌴🌊🏖🏢🌲🌲🌲🌲🏡🏡🌲🌴🏖🌊🌊🌊🌊🌊🏖🏖🏖🌊🌊🏖🌴🌴🌴🌴🌴🌴🌴🌴🌊🏖🌴🌲🌲🌲🌲🌲🌲🏔🏔🌲🌴🌊🌴🌲🏢🌴🌊🌊🌊🌊🏖🌴🏡🏔🌲🏢🌴🌊🌊🌊🌊🏖🌴🌲🏔🏡🌴🌊🌊🌴🌴🌴🌴🏖🌊🌊🌊🌊🌊🌊🌊🌊🏖🏖🌴
🌲🌲🌲🌲🏢🌴🌊🌊🌴🌴🌴🌴🌊🌴🌲🏔🌲🏡🏡🌲🌾🌴🏖🌊🏖🏖🏖🏖🌊🌊🌊🌊🌊🌊🏖🌴🌴🌴🌴🌴🌴🌴🌴🌊🌊🌴🌲🌲🏢🏢🌲🌲🌲🏔🌲🏢🏖🏖🌲🌲🏢🌴🏖🌊🌊🏖🌴🌲🌲🏔🌲🏢🌴🏖🏖🌴🌴🏢🌲🏔🏡🌴🌊🌊🏖🏖🏖🏖🌊🌊🌊🌊🌊🌊🌊🌊🏖🏖🌴🌴
🌲🌲🌲🌲🌲🏢🌴🌊🌊🌴🌴🏖🌊🌴🌲🌲🏡🌲🌾🌴🌴🏖🌊🌴🌴🌴🌴🌴🌴🏖🏖🏖🌊🏖🏖🌴🌴🌴🌴🌴🌴🌴🏖🌊🌊🌴🏡🌲🏢🏢🏢🌲🌲🏔🌲🏢🏖🌊🌾🌲🌲🌴🌴🏖🌊🏖🌴🌲🏡🌲🏔🌲🌲🏢🌴🌴🏢🌲🌲🏔🏡🌴🏖🌊🌊🏖🏖🌊🌊🌊🌊🌊🌊🌊🌊🌊🌊🏖🏖🏖
🌲🏔🌲🌲🌲🌲🌴🌴🌊🌊🏖🌊🏖🌴🌲🏡🌾🌴🌴🏖🌊🌊🌴🌴🌴🌴🌴🌴🌴🌴🌴🌴🌴🌴🌴🏖🏖🌴🌴🌴🌴🏖🌊🌊🌊🌴🌲🏔🌲🏢🌲🌲🌲🌲🌲🌴🌊🏖🌾🌲🌲🏢🌴🌊🌊🌴🌾🏡🌲🌲🌲🏔🌲🌲🌲🌲🌲🌲🌲🏔🌲🌾🌴🌊🌊🌊🌊🌊🌊🌊🌊🌊🌊🌊🌊🌊🌊🌊🏖🏖
🏔🌲🌲🌲🌲🌲🌴🌴🌊🌊🌊🌊🌴🌲🌲🌾🌴🏖🌊🌊🌊🌴🌴🏢🏢🌴🌴🌴🌴🌴🌴🌴🌴🌴🌴🌴🌴🌴🌴🌴🌴🌊🌊🌊🏖🌴🌾🌲🌲🌲🌲🌲🏔🌲🌲🌴🌊🌴🌲🌲🌲🌴🏖🌊🌴🌾🏡🌲🌲🌲🌲🌲🌲🌲🌲🌲🏢🌲🌲🏔🏡🌴🌴🏖🌊🌊🌊🌊🌊🌊🌊🌊🌊🌊🌊🌊🌊🌊🌊🌊
🏔🌲🌲🌲🌲🏢🌴🌴🌊🌊🌊🏖🌴🌲🌲🌴🌊🌊🌊🏖🌴🌴🏢🌲🏢🏢🌴🌴🌴🌴🌴🌴🌴🌴🌴🌴🌴🌴🌴🌴🌴🌊🌊🌊🏖🌴🌾🌲🏔🌲🏔🌲🌲🌲🏢🌊🏖🌾🌲🌲🏢🌴🌊🏖🌴🌲🌲🌲🌲🌲🌲🌲🌲🏔🌲🌲🌲🌲🌲🌲🌾🌴🏖🌊🌊🌊🌊🏖🌴🌴🏖🏖🌊🌊🏖🌊🌊🌊🏖🌊
🏔🌲🌲🏔🌲🌴🌴🏖🌊🌊🌊🌴🌲🌲🌴🏖🌊🌊🌴🌴🌴🏢🌲🌲🌲🏢🏢🌴🌴🌴🌴🌴🌴🌴🌴🌴🌴🏢🏢🌴🌴🌊🌊🌊🏖🌴🌾🏡🌲🌲🌲🌲🌲🌲🌴🌊🌴🌲🏔🌲🌴🌊🌊🌴🌾🌲🌲🌲🏡🏡🏡🏡🏡🌲🌲🌲🌲🌲🏔🏡🌴🌴🌊🌊🌊🏖🌴🌴🌴🌴🌴🌴🏖🏖🏖🌊🌊🌊🏖🏖
🏔🌲🌲🏔🌲🌴🌴🏖🌊🌊🏖🌴🌲🏡🌴🌊🏖🌴🌴🏢🏢🌲🌲🌲🌲🌲🌲🌲🏢🏢🌴🌴🌴🌴🌴🌴🌴🏢🏢🌴🌴🏖🌊🌊🏖🌴🌾🌲🏡🌲🏡🏡🌲🌲🌴🌊🌴🌲🏔🌲🌴🌊🏖🌴🏡🌲🌲🏡🌲🌲🌲🌲🌲🌲🏔🌲🌲🌲🌲🌾🌴🏖🏖🏖🏖🌴🌴🌴🌴🌾🌴🌴🌴🌴🌴🏖🌊🌊🌊🌊
🏔🌲🌲🌲🌲🏢🌴🌴🌊🌊🌴🏢🏔🌾🏖🌊🌴🌴🏢🏢🏢🏢🏢🌲🌲🌲🌲🌲🌲🌲🌲🌲🌲🏢🏢🏢🏢🏢🌴🌴🌴🏖🌊🌊🌴🌴🌾🌲🏡🏡🏡🏡🌲🌲🏢🏖🏖🌾🌲🌲🌴🌊🏖🌴🏡🌲🏡🌲🌲🌲🌲🌾🌲🌲🌲🌲🌲🌲🏡🌴🌴🏖🌴🌴🌴🌴🌴🌴🌴🌾🌾🌾🌾🌴🌴🌴🌊🌊🌊🌊
🌲🏔🌲🌲🏔🌲🌴🌴🏖🏖🌴🌲🌲🌴🌊🌴🌴🏢🏢🏢🏢🌴🌴🏢🌲🏔🌲🏡🏡🏡🌲🌲🌲🏔🌲🌲🏢🏢🌴🌴🌴🌴🌊🌊🌴🌾🌲🌲🌲🌲🏡🌲🏔🌲🏢🌴🌊🌴🏡🌲🌴🌊🌊🌴🌲🏡🌲🌾🌾🌾🌾🌾🌾🌴🌾🌲🏡🌲🌾🌴🌴🌴🌴🌴🌴🌴🌴🌴🌴🌾🌾🌲🌲🌾🌴🌴🏖🌊🌊🌊
🌲🏔🌲🌲🏔🌲🌴🌴🌴🌴🌴🌲🌲🌴🌊🌴🏢🌲🌲🏢🏢🌴🌴🏢🌲🌲🌲🌴🌴🌴🌴🌾🌲🏡🌲🏔🌲🌲🏢🌴🌴🌴🌊🌊🌴🌾🌲🌲🌲🌲🏡🌲🏔🌲🌲🌴🏖🏖🌾🌲🌲🌴🌊🌴🌾🌲🌾🌾🌾🌾🌾🌾🌴🌴🌴🌴🌾🌴🌴🌴🏖🌴🌴🌴🌾🌴🌴🌴🌴🌾🌲🌲🌲🌲🌴🌴🏖🌊🌊🌊
🌲🌲🏔🏔🌲🏢🌴🌴🌴🌴🌴🌲🏡🌴🌊🌴🌲🌲🌲🌲🏢🌴🏢🌲🌲🌲🌴🏖🌊🌊🏖🌴🌴🌴🌾🏡🌲🏔🌲🌲🏢🌴🏖🌊🌴🌾🌲🌾🌾🌾🏡🌲🏔🌲🌲🏢🌴🌊🌴🌲🏔🏢🌊🏖🌴🌾🌾🌴🌾🌾🌾🌾🌴🌴🌴🌴🌴🌴🌴🌊🌊🏖🌴🌴🌾🌾🌴🌴🌾🌾🌲🌲🌲🌾🌴🌴🏖🌊🌊🌊
🌲🌲🌲🌲🏢🌴🌴🏖🏖🌴🏢🏔🌲🏖🌊🌴🌲🌲🌲🌲🌲🌲🌲🌲🏡🌴🏖🌊🌊🌊🌊🌊🌊🌊🌴🌴🌴🌲🌲🏔🌲🏢🌴🌊🌴🌴🌾🌾🌴🌴🌾🏡🌲🏔🌲🌲🌴🌊🏖🌴🌲🌲🌴🌊🌴🌴🌴🌴🌾🌲🌲🌾🌴🌴🌴🌴🌴🌴🌴🌊🌊🌊🏖🌴🌴🌾🌾🌾🌲🌲🌲🌲🌲🌾🌴🌴🌊🌊🌊🏖
🏔🌲🌲🌲🌴🏖🌊🌊🌊🌴🏢🏔🌲🌴🌊🌴🌲🌲🌲🌲🌲🌲🌲🌲🌲🌴🌊🏖🌴🌴🌴🌴🏖🌊🌊🌊🏖🌴🌾🏡🌲🌲🌴🌊🏖🌴🌴🌴🌴🌴🌾🌲🏡🌲🏔🌲🏢🏖🌊🌴🌾🌲🏢🌊🏖🌴🌴🌴🌴🌾🌾🌾🌴🌴🌴🌴🌾🌾🌴🌊🌊🌊🌊🌴🌴🌾🌲🏡🏡🏡🌲🌾🌴🌴🌴🏖🌊🌊🏖🌴
🏔🌲🌲🌲🌴🌊🌊🌊🌊🌴🏢🏔🌲🌴🌊🌴🏢🌲🌲🌲🌲🌲🌲🌲🌴🏖🌊🌴🏢🌲🌲🏢🌴🌴🏖🌊🌊🌊🌴🌴🏡🏔🏢🏖🌊🏖🌴🌴🌴🌴🌴🌾🌾🌲🌲🏔🌲🌴🏖🌊🌴🌲🌲🌴🌊🏖🌴🌴🌴🌴🌾🌾🌾🌾🌲🌲🏡🏡🌾🌴🌊🌊🌊🏖🌴🌾🏡🏡🏡🏡🌲🌾🌴🌴🌴🏖🌊🌊🌴🌴
🌲🏔🌲🏢🌴🌊🌊🌊🌊🌴🌲🏔🏡🌴🏖🌊🌴🌲🌲🌲🌲🌲🏔🏡🌴🌊🏖🏢🌲🌲🌲🏔🌲🏢🌴🏖🌊🌊🏖🌴🌾🌲🌲🌴🌊🌊🏖🌴🌴🌴🌴🌴🌴🌴🌾🏡🌲🌲🌴🏖🌊🌴🌲🏢🌊🌊🌴🌴🌴🌴🌾🌾🌲🏡🏡🌲🌲🌲🏡🌾🌴🏖🌊🏖🌴🌾🏡🏡🏡🌲🌾🌴🌴🌴🌴🌴🌊🌊🌴🌴
🏔🌲🌲🏢🌴🌊🌊🌊🌊🌴🌲🏔🏡🌾🌴🌊🌴🏢🌲🌲🌲🏔🌲🌲🌴🌊🌴🌲🌲🌲🌲🏡🌲🌲🌴🌴🌊🌊🌊🌴🌾🌲🌲🌴🏖🌊🌊🏖🌴🏖🏖🌊🌊🌊🏖🌴🌾🌲🌲🏢🏖🏖🌲🌲🌴🌊🏖🌴🌴🌴🌾🌲🏡🏡🌲🌲🌲🌲🌲🏡🌾🌴🏖🏖🌴🌴🌾🌾🌾🌴🌴🌴🌴🌾🌾🌴🏖🌊🌊🏖
🌲🌲🌲🏢🌴🌊🌊🌊🌊🌴🌲🏔🏡🌲🌴🌊🏖🌴🌲🌲🌲🏔🌲🌾🏖🌊🌴🏔🏡🌾🌾🌲🌲🌲🏢🌴🏖🌊🌊🏖🌴🌲🌲🌴🌴🌊🌊🌊🌊🌊🌊🌊🏖🏖🌊🌊🌴🌴🌲🌲🌴🌊🌴🏔🌴🌊🌊🌴🌴🌾🌲🌲🏡🏡🌲🌲🌲🌲🌲🌲🌲🌴🌴🏖🏖🌴🌴🌴🌴🌴🌴🌴🌲🏡🌲🌾🌴🌊🌊🌊
🌲🌲🏢🌴🌴🌊🌊🌊🌊🌴🌲🏔🌲🌲🌴🏖🌊🌴🌴🌲🌲🌲🌲🌴🌊🏖🏢🏔🏡🌾🌾🌲🌲🌲🏢🌴🏖🌊🌊🏖🌴🌲🌲🌴🌴🌊🌊🌊🌊🏖🌴🌴🌴🌴🌴🏖🌊🏖🌴🌲🌲🏖🌴🌲🌲🏖🌊🌴🌴🌾🌲🌲🌲🌲🏡🏡🌲🌲🌲🌲🌲🌴🌴🌊🏖🌴🌴🌴🌴🏖🌴🌴🌲🌲🌲🌲🌴🏖🌊🌊
🌲🌴🌴🌴🌊🌊🌊🌊🌊🏖🏢🏔🌲🏡🌾🌴🌊🌊🌴🌴🌲🌲🌲🌴🌊🏖🏢🌲🌲🏡🏡🏡🌲🌲🏢🌴🏖🌊🌊🌊🌴🌲🌲🌴🏖🌊🌊🏖🌴🌴🏢🌲🌲🌲🌲🌴🏖🌊🌴🌲🏔🌴🌊🌾🌲🌴🌊🏖🌴🌾🌲🌲🌲🌾🌾🌲🌲🏡🌲🌲🌲🌴🌴🌊🌊🏖🏖🏖🏖🏖🌴🌴🏡🌲🌲🏡🌾🌴🏖🌊
🏢🌴🌴🌊🌊🌊🏖🏖🌊🏖🏢🌲🌲🌲🌲🌾🌴🌊🌊🌴🏢🌲🏡🌴🌊🌊🌴🌲🌲🏔🏔🏔🏔🌲🏢🌴🌴🏖🌊🌊🌴🌲🌲🌴🏖🏖🏖🌴🏢🌲🌲🌲🌲🌲🌲🏢🌴🌊🏖🌴🌲🏢🌊🌴🏡🌲🌴🌊🏖🌴🌾🌾🌴🌴🌴🌴🌾🌲🌲🌲🌾🌴🌴🏖🌊🏖🏖🏖🏖🌴🌴🌴🌲🏡🏡🌲🌾🌴🌴🌴
🌲🌴🌊🌊🏖🏖🌴🏖🌊🏖🌴🌲🌲🏔🌲🌲🌲🌴🌊🏖🌴🌲🏡🌴🏖🌊🌊🏖🌴🌴🏢🌲🌲🏢🌴🌴🏖🌊🌊🏖🌴🌲🌲🌴🌴🌴🌴🏢🌲🌲🌲🌲🌲🌲🌲🌲🌴🌊🏖🌾🌲🌲🌴🌊🌴🌲🌲🌴🌊🌊🌴🌴🌴🏖🏖🌴🌴🌴🌴🌴🌴🌴🌴🏖🏖🏖🏖🌴🌴🌴🌴🌴🌾🌾🌾🌴🌴🌴🌴🌴
🌲🌴🌊🏖🌴🌴🌴🌴🌊🌊🌴🌴🌴🏢🏢🌲🌲🏡🌴🌊🌴🌲🏡🌴🌴🌴🌴🏖🌊🌊🌊🌴🌴🌴🌴🏖🌊🌊🌊🌴🌾🌲🌲🌲🌲🌲🌲🌲🏔🏔🌲🌲🌲🌲🌲🌴🌴🌊🌴🌲🌲🌲🌴🏖🌊🌴🏡🌲🏢🌴🌊🌊🌊🌊🌊🌊🌴🌴🌴🏖🏖🏖🏖🌴🏖🏖🏖🌴🌴🌴🌴🌴🌴🌴🌴🌴🌴🌴🌴🌴
🌲🌴🌊🏖🌴🌴🌴🏖🌊🌊🏖🏖🏖🏖🏖🌴🌴🏔🌾🌊🌴🌲🌲🌲🌲🌾🌾🌲🌾🌴🌴🌊🌊🌊🌊🌊🏖🌴🌴🌴🌲🏡🌲🌲🏔🏔🌲🌲🌲🏔🌲🌲🏢🌴🌴🌴🌊🏖🌴🏡🌲🌲🏢🌴🌊🌊🌴🌲🌲🌲🌴🌴🌴🌴🌴🌊🌊🌊🌊🌊🌊🌊🏖🏖🏖🌊🌊🌊🏖🌴🌴🌴🏖🌊🌊🌊🌊🌊🌊🌊
🏔🌴🌊🏖🌴🌴🌴🏖🌊🌊🌊🌊🌊🌊🌊🌊🌴🌲🏡🌴🏖🌲🌲🌲🌲🌲🌲🌲🏔🌲🏡🌾🌴🌴🌴🌴🌾🌲🌲🌲🌲🌲🌲🌲🌲🌲🌲🌲🏡🌲🌲🏢🌴🌴🌴🏖🌊🌴🌾🌲🏔🌲🌲🌴🏖🌊🌊🌴🌾🌲🏔🌲🌲🌲🌲🌴🌴🏖🌴🌴🏖🌊🌊🌊🌊🌊🌊🌊🌊🌊🌊🌊🌊🌊🌊🌊🌊🌊🌊🌊
🏔🌴🌊🌊🌴🌴🏖🌊🌊🌊🌊🌊🏖🏖🏖🌊🌊🏢🌲🌴🌊🌴🌲🏔🏔🌲🌲🌲🌲🌲🌲🏔🌲🌲🌲🌲🌲🌲🌲🌲🏡🌲🌴🌴🌴🌴🌴🌴🌲🌲🌲🌲🌴🌴🏖🌊🏖🌴🌲🌲🏔🌲🌲🌴🌴🌴🏖🌊🌊🌴🌲🏡🏡🌲🌲🏔🌲🌲🌲🏢🌴🌴🌊🌊🌊🏖🌴🌴🌴🌴🌴🌴🌴🌴🌴🏖🏖🌴🌴🌴
🌲🌴🌊🌊🏖🏖🌊🌊🌊🌊🌊🏖🌴🌴🌴🌴🌊🌴🏔🌴🌊🌴🏢🌲🌲🌲🏢🌴🌴🌴🏢🌲🌲🌲🌲🌲🌲🌲🌲🌲🌲🌾🌴🌴🏖🏖🌴🌴🌾🌲🏔🌲🌴🌴🌊🌊🌴🌲🌲🌲🌲🏔🌲🌲🏢🏢🏢🌴🏖🌊🏖🌴🌴🌴🌴🌾🏡🌲🌲🏔🌲🌴🌴🏖🌴🌴🌲🌲🌲🌲🌲🌲🌲🌲🌲🏢🏢🏢🏢🏢
🌲🌴🌊🌊🏖🌊🌊🌊🌊🌊🌊🏖🌴🌴🌴🌴🌊🌴🏔🌾🏖🌊🌴🌴🌴🌴🌴🌴🌴🌴🌴🌴🌴🌴🏢🏢🌲🌲🌲🏡🌲🌴🌴🌴🏖🏖🏖🌴🌲🌲🏔🌲🏢🏖🌊🌴🌲🌲🌲🌲🏡🏡🌲🏔🌲🌲🌲🌲🏢🌴🌊🌊🌊🌊🌊🌊🌴🌴🌾🏡🌲🌲🌴🌴🌴🌲🌲🌲🏡🌲🌾🌴🌾🌲🏡🌲🏔🌲🌲🌲
🌲🌴🌊🌊🌊🌊🌊🌊🏖🏖🌊🌊🏖🏖🏖🌊🌊🌴🌲🌲🌴🌊🌊🌊🌊🌊🏖🏖🏖🌊🌊🌊🏖🏖🌴🌴🏢🌲🌲🏡🌲🌾🌴🌴🏖🏖🌴🌾🏡🌲🌲🌲🌴🏖🌊🌴🏡🌲🌲🏡🌾🌾🌲🏡🌲🌲🌲🌲🌲🌲🌴🌴🌴🌴🌴🌊🌊🌊🌴🌴🌲🌲🌲🌲🌲🌲🌲🌾🌴🏖🌊🌊🌊🌊🏖🌴🌾🏡🏡🌲
🌲🏢🏖🌊🌊🌊🌊🏖🌴🌴🏖🌊🌊🌊🌊🌊🌊🌴🌲🌲🌴🏖🌊🌊🌊🌊🌊🌊🌊🌊🌊🌊🌊🌊🌊🏖🌴🌲🌲🏡🌲🌾🌾🌴🌴🌴🌴🏡🌲🌲🌲🏢🌴🌊🏖🌴🏡🌲🏡🌾🌴🌴🌴🌲🏡🌲🌲🌲🌲🏔🌲🏢🏢🏢🌴🌴🏖🌊🌊🌊🏖🌴🌲🌲🌲🏡🌴🏖🌊🏖🌴🏢🏢🌴🏖🌊🏖🌴🌴🌴
🏡🌲🌴🌊🌊🌊🏖🌴🌴🌴🌴🌴🌊🌊🌊🌊🌊🌴🌲🌲🌾🌴🌴🌴🌴🏖🌊🌊🏖🌴🌴🌴🌴🏖🌊🌊🌴🏢🌲🌲🏡🏡🌲🌾🌴🌴🌾🌲🌲🏢🌴🌴🌴🌊🏖🌴🌲🏡🌲🌾🌴🌴🌴🌾🌲🌾🌴🌴🌾🌲🏔🌲🌲🌲🏢🌴🌴🌴🏖🏖🌊🌊🌊🌴🌴🌴🌊🏖🌴🌲🏔🌲🏔🌲🏢🌴🏖🌊🌊🌊
🌾🏔🏢🏖🌊🌊🌴🌴🌴🏢🌴🌴🌴🌴🏖🌊🏖🌴🏢🏔🏡🌾🌴🌾🌴🌴🌴🌴🌴🌾🌲🌲🌾🌴🌴🌊🌊🌴🌲🏔🌲🏡🌲🌾🌴🌾🏡🏔🏢🌴🌴🏖🌊🌊🏖🌴🌾🌾🌾🌴🌴🌴🌴🌾🌾🌴🌴🌴🌴🌲🌲🏔🌲🌲🌲🏢🌴🌴🌴🏢🏢🌴🌴🏖🏖🏖🌴🌲🏔🏡🌾🌾🌲🌲🏔🌲🏢🌴🏢🏢
🌴🌲🌲🌴🏖🏖🌴🌴🏢🏢🏢🏢🌴🌴🌴🌴🌴🌴🏢🏔🏡🌲🌲🏡🏡🏡🌲🌲🏡🌲🌲🌲🏡🌲🌴🏖🌊🌴🌲🏔🌲🏡🌲🌾🌾🌲🌲🌲🌴🌊🌊🌊🌊🌊🌴🌴🌴🌴🌴🌴🌴🌴🌴🌴🌴🌴🏖🌊🏖🌴🌲🌲🌲🌲🌲🌲🏢🏢🌲🌲🏔🏔🌲🌲🌲🏔🌲🌲🌴🌴🏖🌴🌴🌾🏡🌲🏔🏔🌲🌲
🌴🌾🌲🌲🌴🌴🌴🌴🏢🏢🌲🏢🏢🌴🌴🌴🌴🌴🏢🌲🌲🏡🏡🌲🌲🏔🏔🏔🌲🌲🌲🏔🌲🌲🌴🌊🏖🌴🌲🌲🌲🌾🌾🌾🌾🏡🌲🌴🌊🌊🌊🏖🏖🌴🌴🌴🌴🌴🌴🌴🌴🌴🌴🏖🌊🌊🌊🌊🌊🏖🌴🌾🏡🌲🏔🌲🌲🌲🏔🌲🏡🌲🌾🌴🌴🌴🏖🌊🌊🌊🌊🌊🏖🌴🌴🌲🌲🌲🌾🌴
🏖🌴🏡🏔🌲🏢🏢🏢🌲🌲🏢🏢🏢🏢🌴🌴🌴🌴🌴🌲🏔🌲🌲🏔🌲🌲🌲🌲🌲🌲🌲🌲🏡🌴🌴🌊🌴🌲🌲🌲🌾🌴🌴🌾🏡🏔🏢🏖🌊🏖🏖🏖🌴🌴🌴🌴🌴🌴🏖🌊🌊🌊🌊🌊🌴🌴🌴🌴🏖🌊🌊🌴🌴🌾🌲🏡🌲🌲🏡🌲🌴🌴🌊🌊🏖🌴🌴🌴🌴🌴🏖🌊🌊🌊🌊🏖🌴🌴🏖🌊
🏖🌴🌴🏡🌲🌲🌲🌲🌲🌲🌲🏢🏢🏢🌴🌴🌴🏖🌴🌴🌲🌲🏔🌲🌲🌲🏢🏢🌲🌲🌲🌲🌴🌴🌊🌊🌴🌲🏔🏡🌾🌴🌾🏡🏔🌲🌴🌊🌊🏖🏖🏖🌴🌴🌴🌴🌴🏖🌊🌊🌊🌊🌴🌴🌲🌲🌲🌲🏢🌴🌴🌊🌊🌊🏖🏖🌴🌴🌴🌴🏖🌊🏖🌴🌲🌲🌲🌲🏢🌴🌴🌴🌴🏖🏖🌊🌊🌊🌊🌊
🌊🏖🌴🌴🌲🏡🌲🌲🌲🌲🌲🏢🏢🌴🌴🌴🌊🌊🌊🌊🌴🏢🌲🌲🌲🏢🏢🏢🌲🌲🌲🌴🏖🌊🌊🏖🌴🏢🌲🌲🏡🌲🌲🏔🌲🌴🌊🌊🌊🌊🌊🌊🌊🌴🌴🌴🏖🌊🌊🏖🌴🌴🏢🌲🌲🌲🌲🌲🌲🏔🌲🌲🏢🌴🌴🌴🏖🌊🌊🌊🏖🌴🌲🏔🌲🏡🌲🏔🌲🌲🌴🌴🌴🌴🌴🌴🌴🏖🏖🌴
🌊🌊🌊🌴🌴🌴🌾🌲🏡🏔🌲🌲🏢🌴🌴🏖🌊🏖🌴🏖🌊🌴🌴🏢🏢🏢🏢🌲🌲🏡🌴🏖🌊🌊🌊🏖🌴🌴🌲🌲🌲🌲🌲🏢🌴🌊🌊🌊🌊🌊🌊🌊🌊🌊🏖🏖🌊🏖🌴🌴🏢🌲🌲🌲🏡🌾🌴🌴🌾🌾🌲🏡🌲🏔🌲🌲🌲🏢🌴🌴🏢🌲🌲🌲🌴🌴🌲🌲🌲🌲🏢🏢🏢🌲🏢🏢🌴🌴🌴🌴
🌊🌊🌊🌊🏖🌴🌴🌴🌾🌲🌲🌲🏢🌴🌴🌊🌴🌾🌾🌴🌴🌊🌴🌴🏢🌲🌲🌲🌲🌲🌴🌊🌊🏖🏖🏖🌴🌴🌴🌲🌲🌲🏢🌴🏖🌊🌊🌊🌊🌊🏖🏖🌊🌊🌊🌊🏖🌴🌲🌲🌲🌲🏔🌲🌲🌴🌴🏖🏖🏖🏖🌴🌴🌾🌲🏡🌲🌲🏔🌲🏔🌲🌾🌴🌴🌴🌾🌲🌲🌲🌲🌲🌲🌲🌲🌲🏢🌴🌴🌴
🌊🌊🌊🌊🌊🌊🏖🌴🌴🌲🌲🌲🏢🌴🌊🏖🌾🏡🌲🏡🌾🏖🏖🌴🏢🌲🌲🌲🌲🌲🌴🌊🌊🏖🏖🏖🌴🌴🌴🏢🌲🏢🌴🏖🌊🌊🌊🌊🏖🌴🌴🌴🌴🏖🏖🌴🏢🌲🏔🌲🌲🏔🌲🌲🌲🌴🌴🌊🌊🌊🌊🌊🌊🏖🌴🌴🌴🌾🌲🏡🌲🌾🌴🌊🌊🏖🌴🏡🏔🌲🌲🌲🌲🌲🌲🌲🏢🌴🌴🌴
🏖🏖🌊🌊🌊🌊🏖🌴🌴🌲🌲🌲🌴🏖🌊🌴🏡🌲🏔🌲🌲🌴🌊🌴🌴🏢🌲🌲🌲🌲🌴🌊🌊🌊🏖🌴🌴🌴🌴🏢🏢🌴🌴🏖🌊🌊🌊🌴🌴🏢🏢🌴🌴🌴🌴🏢🌲🌲🏡🌲🏡🌲🌲🌲🏡🌾🌴🌊🌊🌴🌴🌴🌊🌊🌊🌊🌊🏖🌴🌴🌴🏖🌊🌊🌊🌊🌴🌲🌲🌲🌲🌲🌲🌲🏢🏢🌴🌴🌴🌴
🏖🏖🏖🌊🏖🌴🌴🌴🌾🏡🌲🌲🌴🌊🌴🌲🌲🌲🌲🌲🏡🌴🌊🌊🌴🌴🏢🌲🏔🏡🌴🏖🌊🌊🏖🌴🌴🌴🌴🌴🏢🌴🌴🌴🌴🏖🌴🏢🌲🌲🌲🏢🌴🌴🏢🌲🏔🌲🌲🌴🌾🌲🏡🏡🏡🌲🌴🏖🌊🌴🌴🌴🌴🌊🌊🌊🌊🌊🌊🌊🌊🌊🏖🌴🌴🌊🌊🌴🌲🌲🌲🌲🏢🌴🌴🌴🌴🌴🌴🌴
🏖🏖🏖🏖🌴🌴🌾🌲🏡🌲🌲🏢🏖🌊🌴🌲🌲🌲🌲🏔🏡🌴🏖🌊🌊🏖🌴🏢🌲🏡🌴🌊🌊🌊🏖🌴🌴🌴🌴🌴🌴🏢🏢🌴🌴🌴🏢🌲🏔🌲🏔🌲🌲🏢🌲🌲🌲🏡🌾🌴🌴🌴🌾🌲🌲🌲🌴🏖🌊🌴🏢🏢🌴🌴🌴🌴🌴🌴🏖🌊🏖🌴🌴🏢🏢🌴🌊🌊🌴🌲🌲🌲🌴🌴🏖🌊🌊🌊🏖🌴
🏖🏖🏖🌴🌴🌾🏡🌲🌲🏔🌲🌴🌊🌴🌲🏔🌲🌲🌲🌲🌲🌾🌴🌊🌊🌊🌴🏢🏔🌲🏖🌊🌊🏖🌴🏖🏖🏖🌴🌴🌴🏢🏢🏢🏢🌲🌲🌲🏡🌲🏡🌲🏔🌲🌲🏔🌲🏡🌾🌴🌴🌴🌴🌴🌾🌾🌴🌊🌊🌴🌲🌲🌲🏢🏢🏢🏢🏢🌴🌴🌴🏢🌲🌲🌲🏢🌴🌊🌴🌾🌲🌲🌴🌊🌊🌊🌊🌊🌊🌴
🏖🏖🏖🌴🌾🏡🌲🏔🌲🌲🌴🏖🌊🌴🌲🌲🏢🏢🌲🌲🌲🌲🌴🏖🌊🌊🌴🏢🏔🌾🏖🌊🏖🌴🏖🌊🌊🌊🌊🏖🌴🏢🌲🌲🌲🌲🌲🌲🌴🌴🌴🌾🌲🌲🌲🌲🏡🌲🌾🌴🌴🌴🌴🌴🌴🌴🌴🌊🌊🌴🌲🌲🌲🌲🌲🌲🌲🌲🌲🌲🌲🌲🌲🏔🌲🌲🌴🌊🏖🌾🌲🏢🌊🌊🌴🌴🌴🌊🌊🌊
🌴🌴🌴🌾🏡🌲🏔🌲🌲🏢🌴🌊🌴🌾🌲🌲🏢🏢🏢🌲🌲🌲🌴🏖🌊🌊🌴🌲🌲🌾🏖🌊🌊🏖🌊🌊🌊🌊🌊🌊🌴🏢🌲🌲🏔🌲🌲🌴🌊🌊🌊🌊🌴🌴🌾🌾🌲🌲🌾🌴🌴🏖🏖🏖🌴🌴🏖🌊🌊🌴🏢🌲🌲🌲🌲🏔🏔🏔🌲🌲🌲🌲🌲🌲🌲🏢🌴🌊🌴🌲🌲🌴🌊🌴🌴🌾🌾🌴🏖🌊
🌴🌴🌴🌲🌲🏔🌲🌲🌲🌴🏖🌊🌴🌾🏡🏔🌲🏢🏢🏢🌲🌲🌾🌴🌊🏖🌴🌲🌲🌾🌴🌊🌊🌊🌊🌊🌊🌊🌊🌊🌴🏢🌲🏔🌲🏡🌴🏖🌊🏖🏖🌊🌊🌊🏖🌴🌴🌾🌾🌴🌴🏖🌊🌊🌊🌊🌊🌊🌊🌴🌴🌴🏢🌲🌲🌲🌲🌲🌲🌲🌲🌲🌲🌲🌴🌴🌊🌊🌴🌲🌲🏖🏖🌴🌲🏡🏡🌲🌾🌴
🌲🌾🌾🏡🌲🌲🌲🌲🌲🌲🌴🌊🌊🌴🌴🌲🌲🌲🌲🌲🌲🏔🌲🌴🌊🏖🌴🌲🌲🌲🌴🏖🌊🌊🌊🌊🌊🌊🌊🏖🌴🌲🏔🌲🏡🌾🌴🌊🌊🌴🌴🌴🌴🏖🌊🌊🏖🌴🌴🌴🌴🏖🏖🏖🌊🌊🌊🌊🌊🌊🌊🏖🌴🌴🏢🏢🏢🌲🌲🌲🏢🌴🌴🌴🏖🌊🌊🌴🌾🌲🏢🌊🏖🌴🌲🏡🌲🌲🌲🏡
🏡🌲🌾🌲🏡🌲🏡🏡🌲🌲🏢🏖🌊🌊🌊🌴🌲🌲🌲🌲🌲🏔🏡🌴🌊🌊🌴🌲🌲🌲🌴🏖🌊🌊🌊🌊🌊🏖🌴🌴🌲🌲🌲🌲🌾🌴🏖🌊🏖🌴🌴🌴🌴🌴🌴🌊🌊🏖🌴🌴🌴🌴🏖🏖🏖🌊🌊🌊🌊🌊🌊🌊🌊🌊🏖🌴🌴🌴🌴🌴🌴🌴🏖🌊🌊🌊🏖🌴🌲🏔🏢🌊🏖🌴🌲🏡🌲🌲🌲🌲
🏡🌲🌾🌾🌲🌲🌾🌾🌲🌲🌲🌴🌴🏖🌊🌊🌴🌲🌲🏔🏔🌲🏡🌾🏖🌊🌴🌲🌲🌾🌴🌊🌊🌊🏖🏖🌴🌴🌴🌲🌲🌲🌲🌾🌴🌴🌊🌊🌊🏖🏖🏖🌴🌴🌴🌊🌊🏖🌴🌴🌴🌴🌴🌴🏖🌊🌊🌊🌊🌊🏖🏖🏖🌊🌊🌊🌊🌊🏖🏖🏖🌊🌊🌊🏖🌴🌴🌴🌲🏔🏢🏖🌊🌴🌾🌲🌲🌲🏔🏔
🌲🌲🌾🌴🌴🌴🌴🌴🌾🏡🏔🌲🌴🌴🌴🌊🌊🌴🌲🌲🌲🌲🏡🌾🌴🌊🌴🌲🌲🌴🏖🌊🌊🌴🌴🌴🏢🌲🌲🌲🌲🌲🌴🌴🌴🌊🌊🌊🌊🌊🌊🌊🌊🏖🏖🌊🌊🏖🌴🌴🌴🌴🌴🌴🌴🏖🌊🌊🌊🌴🌴🌴🌴🌴🌴🏖🏖🌊🌊🌊🌊🌊🌴🌴🌴🌴🌴🌾🏡🏔🏢🌴🌊🏖🌴🌾🏡🌲🌲🏔
🌲🏡🌾🌾🌴🌴🌴🌴🌴🌲🌲🌲🌲🏢🌴🌴🌊🌴🌾🏡🏡🏡🏡🌾🌴🌊🌴🌲🏡🌴🌊🌊🌴🌴🌴🌲🌲🌲🏔🌲🏡🌴🌴🏖🌊🌊🌊🌊🌊🌊🌊🌊🌊🌊🌊🌊🏖🌴🌴🌴🌴🌴🌴🌴🌴🌴🌴🏖🌴🌴🌾🌲🌾🌴🌴🌴🌴🏖🌊🏖🌴🌴🌾🌲🌲🌲🌲🏡🌲🌲🏢🌴🌊🌊🌴🌴🌾🏡🌲🌲
🏔🌲🏡🌲🌴🌴🌴🌴🌴🏡🌲🌲🌲🏢🏢🌴🌊🏖🌴🌲🌲🌲🌲🌴🌊🏖🏢🏔🌾🏖🌊🏖🌴🌴🌲🌲🏔🌲🌲🏡🌾🌴🏖🌊🌊🌊🌊🌊🌊🌊🌊🌊🌊🌊🌊🏖🌴🌴🌴🌾🌾🌴🌾🌾🌾🌴🌴🌴🌴🌲🏡🏡🌲🌾🌴🌴🏖🏖🌴🌴🌴🌲🏡🌲🌲🌲🌲🏔🌲🏢🌴🏖🌊🌊🌴🌴🌾🌲🌲🌲
🏔🌲🌲🏡🌲🌾🌾🌾🌲🌲🌲🏢🌴🌴🌴🌴🌊🌴🌾🏡🌲🌲🌲🌴🌊🌴🌲🌲🌴🌊🌊🌴🌴🌴🌲🌲🌲🌲🌲🏡🌾🌴🌊🌊🌊🌊🌊🏖🌊🌊🌊🌊🌊🌊🌊🌴🌴🌴🌾🌾🌾🌴🌾🌾🌾🌴🌴🌴🌾🏡🌲🌲🏡🌴🌴🌴🏖🏖🌴🌴🌲🏡🌲🏔🌲🌲🌲🌲🏢🌴🏖🌊🌊🏖🌴🌴🌾🌲🌲🌲
🏔🌲🌲🌲🌲🏡🏡🏡🌲🌲🌴🌴🌊🌊🌊🌊🌊🌴🌲🌲🏔🌲🌲🌴🌊🌴🌲🏡🌴🌊🏖🌴🌴🌴🌲🏔🌲🌲🏡🏡🌾🌴🌊🌊🌊🌊🏖🏖🏖🌊🌊🌊🌊🌊🌊🌴🌴🌾🌾🌾🌾🌴🌴🌾🌾🌴🌴🌴🌾🏡🌲🌲🌲🌴🌴🌴🌴🌴🌴🌾🌲🌲🌲🌲🌲🌲🏢🌴🌴🏖🌊🌊🌴🌴🌾🌲🌲🏡🌲🏔
