🏔🌲🌲🌲🌲🌲🌲🌲🌲🌲🏢🏢🏢🏢🌴🌴🌴🌴🌴🌴🌴🌴🌴🌴🌴🌴🌴🌴🌴🌴🌴🌴🌴🌴🌴🌴🌴🌴🌴🌴🌴🌴🌴🌴🌴🌴🌴🌴🌴🌴🌴🌴🌴🏢🏢🏢🏢🏢🏢🏢🏢🏢🏢🏢🏢🏢🏢🏢🌲🌲🌲🌲🌲🌲🌲🌲🌲🌲🌲🌲🌲🌲🌲🌲🌲🌲🌲🌲🌲🌲🌲🌲🌲🌲🌲🌲🌲🌲🌲🏔
🌲🏔🌲🌲🌲🌲🌲🌲🌲🌲🌲🏢🏢🏢🏢🏢🌴🌴🌴🌴🌴🌴🌴🌴🌴🌴🌴🌴🌴🌴🌴🌴🌴🌴🌴🌴🌴🌴🌴🌴🌴🌴🌴🌴🌴🌴🌴🌴🌴🌴🌴🌴🏢🏢🏢🏢🏢🏢🏢🏢🏢🏢🏢🏢🏢🏢🏢🏢🌲🌲🌲🌲🌲🌲🌲🌲🌲🌲🌲🌲🌲🌲🌲🌲🌲🌲🌲🌲🌲🌲🌲🌲🌲🌲🌲🌲🌲🌲🌲🏔
🌲🏔🏔🌲🌲🌲🌲🌲🌲🌲🌲🌲🏢🏢🏢🏢🏢🏢🌴🌴🌴🌴🌴🌴🌴🌴🌴🌴🌴🌴🌴🌴🌴🌴🌴🌴🌴🌴🌴🌴🌴🌴🌴🌴🌴🌴🌴🌴🌴🌴🌴🌴🏢🏢🏢🏢🏢🏢🏢🏢🏢🏢🏢🏢🏢🏢🏢🏢🌲🌲🌲🌲🌲🌲🌲🌲🌲🌲🌲🌲🌲🌲🌲🌲🌲🌲🌲🌲🌲🌲🏔🌲🌲🌲🌲🌲🌲🌲🏔🏔
🌲🌲🏔🏔🌲🌲🌲🌲🌲🌲🌲🌲🌲🏢🏢🏢🏢🏢🏢🏢🏢🏢🌴🌴🌴🌴🌴🌴🌴🌴🌴🌴🌴🌴🌴🌴🌴🌴🌴🌴🌴🌴🌴🌴🌴🌴🌴🌴🌴🌴🌴🌴🏢🏢🏢🏢🏢🏢🏢🏢🏢🏢🏢🏢🏢🏢🏢🏢🌲🌲🌲🌲🌲🌲🌲🌲🌲🌲🌲🌲🌲🌲🌲🌲🌲🌲🌲🌲🏔🏔🏔🌲🌲🌲🌲🌲🌲🌲🏔🏔
🌲🌲🌲🏔🏔🏔🌲🌲🌲🌲🌲🌲🌲🌲🏢🏢🏢🏢🏢🏢🏢🏢🏢🏢🌴🌴🌴🌴🌴🌴🌴🌴🌴🌴🌴🌴🌴🌴🌴🌴🌴🌴🌴🌴🌴🌴🌴🌴🌴🌴🌴🏢🏢🏢🏢🏢🏢🏢🏢🌴🌴🌴🏢🏢🏢🏢🏢🏢🌲🌲🌲🌲🌲🌲🌲🌲🌲🌲🌲🌲🌲🌲🌲🌲🌲🌲🏔🏔🏔🏔🏔🏔🌲🌲🌲🌲🌲🏔🏔🏔
🌲🌲🌲🌲🏔🏔🌲🌲🌲🌲🌲🌲🌲🌲🌲🏢🏢🏢🏢🏢🏢🏢🏢🏢🏢🌴🌴🌴🌴🌴🌴🌴🌴🌴🌴🌴🌴🌴🌴🌴🌴🌴🏢🏢🏢🏢🏢🏢🌴🏢🏢🏢🏢🏢🏢🏢🏢🏢🌴🌴🌴🌴🏢🏢🏢🏢🏢🏢🌲🌲🌲🌲🌲🌲🌲🌲🌲🌲🌲🌲🌲🌲🌲🌲🌲🏔🏔🏔🏔🏔🏔🏔🏔🏔🏔🏔🏔🏔🏔🏔
🌲🌲🌲🌲🌲🏔🏔🌲🌲🌲🌲🌲🌲🌲🌲🌲🌲🏢🏢🏢🏢🏢🏢🏢🏢🌴🌴🌴🌴🌴🌴🌴🌴🌴🌴🌴🌴🌴🌴🌴🏢🏢🏢🏢🏢🏢🏢🏢🏢🏢🏢🏢🏢🏢🏢🏢🏢🏢🌴🌴🌴🌴🏢🏢🏢🏢🏢🏢🌲🌲🌲🌲🌲🌲🌲🌲🌲🌲🌲🏔🏔🏔🌲🏔🏔🏔🏔🏔🏔🏔🏔🏔🏔🏔🏔🏔🏔🏔🏔🏔
🌲🌲🌲🌲🌲🏔🏔🏔🌲🌲🌲🌲🌲🌲🌲🌲🌲🌲🌲🌲🌲🌲🏢🏢🏢🏢🌴🌴🌴🌴🌴🌴🌴🌴🌴🌴🌴🌴🌴🏢🏢🏢🏢🏢🏢🏢🏢🏢🏢🏢🏢🏢🏢🏢🏢🏢🏢🏢🏢🌴🌴🌴🏢🏢🏢🏢🏢🏢🌲🌲🌲🌲🌲🌲🌲🌲🌲🌲🏔🏔🏔🏔🏔🏔🏔🏔🏔🏔🏔🏔🏔🏔🏔🏔🏔🏔🏔🏔🏔🏔
🌲🌲🌲🌲🌲🌲🏔🏔🏔🏔🌲🌲🌲🌲🌲🌲🌲🌲🌲🌲🌲🌲🌲🏢🏢🏢🌴🌴🌴🌴🌴🌴🌴🌴🌴🌴🌴🌴🌴🏢🏢🏢🏢🏢🏢🏢🏢🏢🏢🏢🏢🏢🏢🌲🏢🏢🏢🏢🏢🌴🌴🏢🏢🏢🏢🏢🏢🏢🌲🌲🌲🌲🌲🌲🌲🌲🌲🏔🏔🏔🏔🏔🏔🏔🏔🏔🏔🏔🏔🏔🏔🏔🏔🏔🏔🏔🌲🌲🌲🌲
🌲🌲🌲🌲🌲🌲🌲🏔🏔🏔🏔🏔🌲🌲🌲🌲🌲🌲🌲🌲🌲🌲🌲🏢🏢🏢🏢🌴🌴🌴🌴🌴🌴🌴🌴🌴🌴🌴🌴🏢🏢🏢🏢🏢🏢🏢🏢🏢🏢🏢🏢🏢🏢🏢🏢🏢🏢🏢🏢🏢🏢🏢🏢🏢🏢🏢🏢🌲🌲🌲🌲🌲🌲🌲🌲🌲🌲🏔🏔🏔🏔🏔🏔🏔🏔🏔🏔🏔🏔🏔🏔🌲🌲🌲🌲🌲🌲🌲🌲🌲
🏡🌲🌲🌲🌲🌲🌲🌲🌲🏔🏔🏔🌲🌲🌲🌲🌲🌲🌲🌲🌲🌲🌲🌲🏢🏢🏢🏢🏢🌴🌴🌴🌴🏢🏢🏢🏢🏢🏢🏢🏢🏢🏢🏢🏢🏢🏢🏢🏢🏢🏢🏢🏢🏢🏢🏢🏢🏢🏢🏢🏢🏢🏢🏢🏢🏢🏢🌲🌲🌲🌲🌲🌲🌲🌲🌲🌲🏔🏔🏔🏔🏔🏔🏔🏔🏔🏔🌲🌲🌲🌲🌲🌲🌲🌲🌲🌲🌲🌲🌲
🏡🌲🌲🌲🌲🌲🌲🌲🌲🌲🏔🏔🏔🌲🌲🌲🌲🌲🌲🌲🌲🌲🌲🌲🌲🌲🏢🏢🏢🏢🏢🏢🏢🏢🏢🏢🏢🏢🏢🏢🏢🏢🏢🏢🏢🏢🏢🏢🏢🏢🏢🏢🏢🏢🏢🏢🏢🏢🏢🏢🏢🏢🏢🏢🏢🏢🌲🌲🌲🌲🌲🌲🌲🌲🌲🌲🌲🌲🏔🏔🏔🏔🏔🏔🏔🏔🌲🌲🌲🌲🌲🌲🌲🌲🌲🌲🌲🌲🌲🌲
🏡🏡🌲🌲🌲🌲🌲🌲🌲🌲🌲🏔🏔🌲🌲🌲🌲🌲🌲🌲🌲🌲🌲🌲🌲🌲🌲🌲🏢🏢🏢🏢🏢🏢🏢🏢🏢🏢🏢🏢🏢🏢🌲🌲🌲🌲🏢🏢🏢🏢🏢🏢🏢🏢🏢🏢🏢🏢🏢🏢🏢🏢🏢🏢🏢🌲🌲🌲🌲🌲🌲🌲🌲🌲🌲🌲🌲🌲🌲🏔🏔🏔🏔🏔🏔🌲🌲🌲🌲🌲🌲🌲🌲🌲🌲🌲🌲🌲🌲🌲
🏡🏡🌲🌲🌲🌲🌲🌲🌲🌲🌲🏔🏔🌲🌲🌲🌲🌲🌲🌲🌲🌲🌲🌲🌲🌲🌲🌲🌲🏢🏢🏢🏢🏢🏢🏢🏢🏢🏢🏢🌲🌲🌲🌲🌲🌲🏢🏢🏢🏢🏢🏢🏢🏢🏢🏢🏢🏢🏢🏢🏢🏢🏢🌲🌲🌲🌲🌲🌲🌲🌲🌲🌲🌲🌲🌲🌲🌲🌲🏔🏔🏔🏔🏔🏔🌲🌲🌲🌲🌲🌲🌲🌲🌲🌲🌲🌲🌲🌲🌲
🏡🏡🌲🌲🌲🌲🌲🌲🌲🌲🌲🏔🏔🌲🌲🌲🌲🌲🌲🌲🌲🌲🌲🌲🌲🌲🌲🌲🌲🌲🏢🏢🏢🏢🏢🏢🏢🏢🌲🌲🌲🌲🌲🌲🌲🌲🌲🏢🏢🏢🏢🏢🏢🏢🏢🏢🏢🏢🏢🏢🏢🏢🌲🌲🌲🌲🌲🌲🌲🌲🌲🌲🌲🌲🌲🌲🌲🌲🌲🏔🏔🏔🏔🏔🏔🌲🌲🌲🌲🌲🌲🌲🌲🌲🌲🌲🌲🌲🌲🌲
🏡🏡🏡🌲🌲🌲🌲🌲🌲🌲🌲🏔🏔🌲🌲🌲🌲🌲🌲🌲🌲🌲🌲🌲🌲🌲🌲🌲🌲🌲🌲🌲🏢🏢🏢🏢🏢🌲🌲🌲🌲🌲🌲🌲🌲🌲🌲🏢🏢🏢🏢🏢🏢🏢🏢🏢🌴🏢🏢🏢🏢🏢🌲🌲🌲🌲🌲🌲🌲🌲🌲🌲🌲🌲🌲🌲🌲🌲🌲🌲🏔🏔🏔🏔🏔🌲🌲🌲🌲🌲🌲🌲🌲🌲🌲🌲🌲🌲🌲🌲
🏡🏡🏡🌲🌲🌲🌲🌲🌲🌲🌲🏔🏔🏔🌲🌲🌲🌲🌲🌲🌲🌲🌲🌲🌲🌲🌲🌲🌲🌲🌲🌲🌲🏢🏢🏢🏢🌲🌲🌲🌲🌲🌲🌲🌲🌲🌲🏢🏢🏢🏢🏢🏢🏢🏢🏢🏢🏢🏢🏢🏢🏢🌲🌲🌲🌲🌲🌲🌲🌲🌲🌲🌲🌲🌲🌲🌲🌲🌲🌲🌲🏔🏔🏔🏔🏔🌲🌲🌲🌲🌲🌲🌲🌲🌲🌲🌲🌲🌲🌲
🏡🏡🏡🌲🌲🌲🌲🌲🌲🌲🌲🌲🏔🏔🏔🏔🏔🏔🏔🏔🏔🏔🌲🌲🌲🌲🌲🌲🌲🌲🌲🌲🌲🏢🏢🏢🏢🌲🌲🌲🌲🌲🌲🌲🌲🌲🌲🌲🏢🏢🏢🏢🏢🏢🏢🏢🏢🏢🏢🏢🏢🏢🌲🌲🌲🌲🌲🌲🌲🌲🌲🌲🌲🌲🌲🌲🌲🌲🌲🌲🌲🏔🏔🏔🏔🏔🌲🌲🌲🌲🌲🌲🌲🌲🌲🌲🌲🌲🌲🌲
🏡🏡🏡🌲🌲🌲🌲🌲🌲🌲🌲🌲🌲🏔🏔🏔🏔🏔🏔🏔🏔🏔🏔🏔🌲🌲🌲🌲🌲🌲🌲🌲🌲🏢🏢🏢🏢🌲🌲🌲🌲🌲🌲🌲🌲🌲🌲🌲🏢🏢🏢🏢🏢🏢🏢🏢🏢🏢🏢🏢🏢🌲🌲🌲🌲🌲🌲🌲🌲🌲🌲🌲🌲🌲🌲🌲🌲🌲🌲🌲🌲🏔🏔🏔🏔🏔🌲🌲🌲🌲🌲🌲🌲🌲🌲🌲🌲🌲🌲🌲
🏡🏡🏡🌲🌲🌲🌲🌲🌲🌲🌲🌲🌲🌲🏔🏔🏔🌲🌲🌲🏔🏔🏔🏔🌲🌲🌲🌲🌲🌲🌲🌲🌲🌲🏢🏢🌲🌲🌲🌲🌲🌲🌲🌲🌲🌲🌲🌲🌲🏢🏢🏢🌲🏢🏢🏢🏢🏢🏢🏢🌲🌲🌲🌲🌲🌲🌲🌲🌲🌲🌲🌲🌲🌲🌲🌲🌲🌲🌲🌲🏔🏔🏔🏔🏔🏔🌲🌲🌲🌲🌲🌲🌲🌲🌲🌲🌲🌲🌲🌲
🏡🏡🌲🌲🌲🌲🌲🌲🌲🌲🌲🌲🌲🌲🌲🌲🌲🌲🌲🌲🌲🏔🏔🏔🌲🌲🌲🌲🌲🌲🌲🌲🌲🌲🌲🌲🌲🌲🌲🌲🌲🌲🌲🌲🌲🌲🌲🌲🌲🌲🌲🌲🌲🌲🌲🌲🌲🏢🌲🌲🌲🌲🌲🌲🌲🌲🌲🌲🌲🌲🌲🌲🌲🌲🌲🌲🌲🌲🌲🏔🏔🏔🏔🏔🏔🌲🌲🌲🌲🌲🌲🌲🌲🌲🌲🌲🌲🌲🌲🌲
🏡🏡🌲🌲🌲🌲🌲🌲🌲🌲🌲🌲🌲🌲🌲🌲🌲🌲🌲🌲🌲🌲🏔🏔🌲🌲🌲🌲🌲🌲🌲🌲🌲🌲🌲🌲🌲🌲🌲🌲🌲🌲🌲🌲🌲🌲🌲🌲🌲🌲🌲🌲🌲🌲🌲🌲🌲🌲🌲🌲🌲🌲🌲🌲🌲🌲🌲🌲🌲🌲🌲🌲🌲🌲🌲🌲🌲🌲🌲🏔🏔🏔🌲🌲🌲🌲🌲🌲🌲🌲🌲🌲🌲🌲🌲🌲🌲🌲🌲🌲
🏡🏡🌲🌲🌲🌲🌲🌲🌲🌲🌲🌲🌲🌲🌲🌲🌲🌲🌲🌲🌲🌲🏔🏔🌲🌲🌲🌲🌲🌲🌲🌲🌲🌲🌲🌲🌲🌲🌲🌲🌲🌲🌲🌲🌲🌲🌲🌲🌲🌲🌲🌲🌲🌲🌲🌲🌲🌲🌲🌲🌲🌲🌲🌲🌲🌲🌲🌲🌲🌲🌲🌲🌲🌲🌲🌲🌲🌲🏔🏔🏔🌲🌲🌲🌲🌲🌲🌲🌲🌲🌲🌲🌲🌲🌲🌲🌲🌲🌲🌲
🏡🏡🏡🌲🌲🌲🌲🌲🌲🌲🌲🌲🌲🌲🌲🌲🌲🌲🌲🌲🌲🌲🏔🏔🌲🌲🌲🌲🌲🌲🌲🌲🌲🌲🌲🌲🌲🌲🌲🌲🌲🌲🌲🌲🌲🌲🌲🌲🌲🌲🌲🌲🌲🌲🌲🌲🌲🌲🌲🌲🌲🌲🌲🌲🌲🌲🌲🌲🌲🌲🌲🌲🌲🌲🌲🌲🌲🏔🏔🏔🌲🌲🌲🌲🌲🌲🌲🌲🌲🌲🌲🌲🌲🌲🌲🌲🌲🌲🌲🌲
🏡🏡🏡🌲🌲🌲🌲🌲🌲🌲🌲🌲🌲🌲🌲🌲🌲🌲🌲🌲🌲🌲🏔🏔🌲🌲🌲🌲🌲🌲🌲🌲🌲🌲🌲🌲🌲🌲🌲🌲🌲🌲🌲🌲🌲🌲🌲🌲🌲🌲🌲🌲🌲🌲🌲🌲🌲🌲🌲🌲🌲🌲🌲🌲🌲🌲🌲🌲🌲🌲🌲🌲🌲🌲🌲🌲🏔🏔🏔🌲🌲🌲🌲🌲🌲🌲🌲🌲🌲🌲🌲🌲🌲🌲🌲🌲🌲🌲🌲🌲
🌲🏡🏡🌲🌲🌲🌲🌲🌲🌲🌲🌲🌲🌲🌲🌲🌲🌲🌲🌲🌲🌲🏔🏔🏔🌲🌲🌲🌲🌲🌲🌲🌲🌲🌲🌲🌲🌲🌲🌲🌲🌲🌲🌲🌲🌲🌲🌲🌲🌲🌲🌲🌲🌲🌲🌲🌲🌲🌲🌲🌲🌲🌲🌲🌲🌲🌲🌲🌲🌲🌲🌲🌲🌲🌲🏔🏔🏔🌲🌲🌲🌲🌲🌲🌲🌲🌲🌲🌲🌲🌲🌲🌲🌲🌲🌲🌲🌲🌲🌲
🌲🏡🏡🌲🌲🌲🌲🌲🌲🌲🌲🌲🌲🌲🌲🌲🌲🌲🌲🌲🌲🌲🏔🏔🏔🌲🌲🌲🌲🌲🌲🌲🌲🌲🌲🌲🌲🌲🌲🌲🌲🌲🌲🌲🌲🌲🌲🌲🌲🌲🌲🌲🌲🌲🌲🌲🌲🌲🌲🌲🌲🌲🌲🌲🌲🌲🌲🌲🌲🌲🌲🌲🌲🌲🌲🏔🏔🏔🌲🌲🌲🌲🌲🌲🌲🌲🌲🌲🌲🌲🌲🌲🌲🌲🌲🌲🌲🌲🌲🌲
🌲🏡🏡🏡🌲🌲🌲🌲🌲🌲🌲🌲🌲🌲🌲🌲🌲🌲🌲🌲🌲🌲🏔🏔🏔🌲🌲🌲🌲🌲🌲🌲🌲🌲🌲🌲🌲🌲🌲🌲🌲🏔🏔🏔🏔🌲🌲🌲🌲🌲🌲🌲🌲🌲🌲🌲🌲🌲🌲🌲🌲🌲🌲🌲🌲🌲🌲🌲🌲🌲🌲🌲🌲🌲🏔🏔🏔🏔🌲🌲🌲🌲🌲🌲🌲🌲🌲🌲🌲🌲🌲🌲🌲🌲🌲🌲🌲🌲🌲🌲
🌲🌲🏡🏡🌲🌲🌲🌲🌲🌲🌲🌲🌲🌲🌲🌲🌲🌲🌲🌲🌲🏔🏔🏔🌲🌲🌲🌲🌲🌲🌲🌲🌲🌲🌲🌲🌲🌲🌲🌲🏔🏔🏔🏔🏔🏔🏔🌲🌲🌲🌲🌲🌲🌲🌲🌲🌲🌲🌲🌲🌲🌲🌲🌲🌲🌲🌲🌲🌲🌲🌲🌲🌲🏔🏔🏔🏔🌲🌲🌲🌲🌲🌲🌲🌲🌲🌲🌲🌲🌲🌲🌲🌲🌲🌲🏔🏔🏔🏔🏔
🌲🌲🏡🏡🌲🌲🌲🌲🌲🌲🌲🌲🌲🌲🌲🌲🌲🌲🌲🌲🏔🏔🏔🏔🌲🌲🌲🌲🌲🌲🌲🌲🌲🌲🌲🌲🌲🌲🏔🏔🏔🏔🏔🏔🏔🏔🏔🏔🏔🏔🏔🏔🏔🌲🌲🌲🌲🌲🌲🌲🌲🌲🌲🌲🌲🌲🌲🌲🌲🌲🌲🌲🌲🏔🏔🏔🏔🌲🌲🌲🌲🌲🌲🌲🌲🌲🌲🌲🌲🌲🌲🌲🌲🌲🌲🏔🏔🏔🏔🏔
🌲🌲🏡🏡🌲🌲🌲🌲🌲🌲🌲🌲🌲🌲🌲🌲🌲🌲🌲🌲🏔🏔🏔🌲🌲🌲🌲🌲🌲🌲🌲🌲🌲🌲🌲🌲🌲🏔🏔🏔🏔🏔🏔🏔🏔🏔🏔🏔🏔🏔🏔🏔🏔🏔🌲🌲🌲🌲🌲🌲🌲🌲🌲🌲🌲🌲🌲🌲🌲🌲🌲🌲🌲🏔🏔🏔🏔🏔🌲🌲🌲🌲🌲🌲🌲🌲🌲🌲🌲🌲🌲🌲🌲🌲🌲🌲🏔🏔🏔🏔
🌲🌲🏡🏡🌲🌲🌲🌲🌲🌲🌲🌲🌲🌲🌲🌲🌲🌲🌲🌲🏔🏔🏔🌲🌲🌲🌲🌲🌲🌲🌲🌲🌲🌲🌲🌲🏔🏔🏔🏔🏔🏔🏔🏔🌲🌲🌲🌲🏔🏔🏔🏔🏔🏔🏔🏔🌲🌲🌲🌲🌲🌲🌲🌲🌲🌲🌲🌲🌲🌲🌲🌲🌲🌲🏔🏔🏔🏔🏔🌲🌲🌲🌲🌲🌲🌲🌲🌲🌲🌲🌲🌲🌲🌲🌲🌲🏔🏔🏔🏔
🌲🏡🏡🏡🌲🌲🌲🌲🌲🌲🌲🌲🌲🌲🌲🌲🌲🌲🌲🌲🌲🏔🏔🏔🌲🌲🌲🌲🌲🌲🌲🌲🌲🌲🌲🏔🏔🏔🏔🌲🌲🌲🌲🌲🌲🌲🌲🌲🌲🏔🏔🏔🏔🏔🏔🏔🏔🏔🌲🌲🌲🌲🌲🌲🌲🌲🌲🌲🌲🌲🌲🌲🌲🌲🌲🏔🏔🏔🏔🏔🌲🌲🌲🌲🌲🌲🌲🌲🌲🌲🌲🌲🌲🌲🌲🌲🏔🏔🏔🏔
🏡🏡🏡🏡🌲🌲🌲🌲🌲🌲🌲🌲🌲🌲🌲🌲🌲🌲🌲🌲🌲🏔🏔🏔🏔🌲🌲🌲🌲🌲🌲🌲🌲🌲🏔🏔🏔🌲🌲🌲🌲🌲🌲🌲🌲🌲🌲🌲🌲🌲🏔🏔🏔🏔🏔🏔🏔🏔🏔🏔🌲🌲🌲🌲🌲🌲🌲🌲🌲🌲🌲🌲🌲🌲🌲🌲🏔🏔🏔🏔🏔🌲🌲🌲🌲🌲🌲🌲🌲🌲🌲🌲🌲🌲🌲🌲🏔🏔🏔🏔
🏡🏡🏡🌲🌲🌲🌲🌲🌲🌲🌲🌲🌲🌲🌲🌲🌲🌲🌲🌲🌲🌲🏔🏔🏔🏔🏔🏔🏔🌲🌲🌲🌲🏔🏔🏔🌲🌲🌲🌲🌲🌲🌲🌲🌲🌲🌲🌲🌲🌲🌲🏔🌲🌲🌲🌲🌲🏔🏔🏔🌲🌲🌲🌲🌲🌲🌲🌲🌲🌲🌲🌲🌲🌲🌲🌲🏔🏔🏔🏔🏔🏔🌲🌲🌲🌲🌲🌲🌲🌲🌲🌲🌲🌲🌲🌲🏔🏔🏔🏔
🏡🏡🏡🌲🌲🌲🌲🌲🌲🌲🌲🌲🌲🌲🌲🌲🌲🌲🌲🌲🌲🌲🌲🏔🏔🏔🏔🏔🏔🏔🏔🏔🏔🏔🏔🏔🌲🌲🌲🌲🌲🌲🌲🌲🌲🌲🌲🌲🌲🌲🌲🌲🌲🌲🌲🌲🌲🏔🏔🏔🌲🌲🌲🌲🌲🌲🌲🌲🌲🌲🌲🌲🌲🌲🌲🏔🏔🏔🏔🏔🏔🏔🏔🌲🌲🌲🌲🌲🌲🌲🌲🌲🌲🌲🌲🌲🏔🏔🏔🏔
🏡🏡🌲🌲🌲🌲🌲🌲🌲🌲🌲🌲🌲🌲🌲🌲🌲🌲🌲🌲🌲🌲🌲🌲🏔🏔🏔🏔🏔🏔🏔🏔🏔🏔🏔🌲🌲🌲🌲🌲🌲🌲🌲🌲🌲🌲🌲🌲🌲🌲🌲🌲🌲🌲🌲🌲🌲🏔🏔🏔🌲🌲🌲🌲🌲🌲🌲🌲🌲🌲🌲🌲🌲🌲🌲🏔🏔🏔🌲🌲🌲🌲🌲🌲🌲🌲🌲🌲🌲🌲🌲🌲🌲🌲🌲🌲🏔🏔🏔🏔
🏡🏡🌲🌲🌲🌲🌲🌲🌲🏔🏔🏔🏔🌲🌲🌲🌲🌲🌲🌲🌲🌲🌲🌲🌲🏔🏔🏔🏔🏔🏔🏔🌲🌲🌲🌲🌲🌲🌲🌲🌲🌲🌲🌲🌲🌲🌲🌲🌲🌲🌲🌲🌲🌲🌲🌲🏔🏔🏔🏔🌲🌲🌲🌲🌲🌲🌲🌲🌲🌲🌲🌲🌲🌲🌲🏔🏔🏔🌲🌲🌲🌲🌲🌲🌲🌲🌲🌲🌲🌲🌲🌲🌲🌲🌲🌲🏔🏔🏔🏔
🌲🌲🌲🌲🌲🌲🌲🌲🌲🏔🏔🏔🏔🏔🌲🌲🌲🌲🌲🌲🌲🌲🌲🌲🌲🌲🌲🌲🌲🌲🌲🌲🌲🌲🌲🌲🌲🌲🌲🌲🌲🌲🌲🌲🌲🌲🌲🌲🌲🌲🌲🌲🌲🌲🌲🌲🏔🏔🏔🏔🌲🌲🌲🌲🌲🌲🌲🌲🌲🌲🌲🌲🌲🌲🌲🏔🏔🌲🌲🌲🌲🌲🌲🌲🌲🌲🌲🌲🌲🌲🌲🌲🌲🌲🌲🌲🌲🏔🏔🏔
🌲🌲🌲🌲🌲🌲🌲🌲🌲🏔🏔🏔🏔🏔🏔🌲🌲🌲🌲🌲🌲🌲🌲🌲🌲🌲🌲🌲🌲🌲🌲🌲🌲🌲🌲🌲🌲🌲🌲🌲🌲🌲🌲🌲🌲🌲🌲🌲🌲🌲🌲🌲🌲🌲🏔🏔🏔🏔🏔🌲🌲🌲🌲🌲🌲🌲🌲🌲🌲🌲🌲🌲🌲🌲🌲🏔🏔🌲🌲🌲🌲🌲🌲🌲🌲🌲🌲🌲🌲🌲🌲🌲🌲🌲🌲🌲🌲🌲🌲🌲
🌲🌲🌲🌲🌲🌲🌲🌲🏔🏔🏔🏔🏔🏔🏔🏔🌲🌲🌲🌲🌲🌲🌲🌲🌲🌲🌲🌲🌲🌲🌲🌲🌲🌲🌲🌲🌲🌲🌲🌲🏡🌲🌲🌲🌲🌲🌲🌲🌲🌲🌲🌲🌲🏔🏔🏔🏔🏔🌲🌲🌲🌲🌲🌲🌲🌲🌲🌲🌲🌲🌲🌲🌲🌲🏔🏔🏔🌲🌲🌲🌲🌲🌲🌲🌲🌲🌲🌲🌲🌲🌲🌲🌲🌲🌲🌲🌲🌲🌲🌲
🌲🌲🌲🌲🌲🌲🌲🌲🏔🏔🏔🏔🏔🏔🏔🏔🏔🌲🌲🌲🌲🌲🌲🌲🌲🌲🌲🌲🌲🌲🌲🌲🌲🌲🌲🌲🌲🌲🌲🌲🌲🌲🌲🌲🌲🌲🌲🌲🌲🌲🌲🌲🏔🏔🏔🏔🏔🌲🌲🌲🌲🌲🌲🌲🌲🌲🌲🌲🌲🌲🌲🌲🌲🌲🏔🏔🏔🌲🌲🌲🌲🌲🌲🌲🌲🌲🌲🌲🌲🌲🌲🌲🌲🌲🌲🌲🌲🌲🌲🌲
🌲🌲🌲🌲🌲🌲🌲🌲🏔🏔🏔🏔🏔🏔🏔🏔🏔🌲🌲🌲🌲🌲🌲🌲🌲🌲🌲🌲🌲🌲🌲🌲🌲🌲🌲🌲🌲🌲🌲🌲🌲🌲🌲🌲🌲🌲🌲🌲🌲🌲🌲🏔🏔🏔🏔🏔🏔🌲🌲🌲🌲🌲🌲🌲🌲🌲🌲🌲🌲🌲🌲🌲🏔🏔🏔🏔🌲🌲🌲🌲🌲🌲🌲🌲🌲🌲🌲🌲🌲🌲🌲🌲🌲🌲🌲🌲🌲🌲🌲🌲
🌲🌲🌲🌲🌲🌲🌲🏔🏔🏔🏔🏔🏔🏔🏔🏔🏔🏔🌲🌲🌲🌲🌲🌲🌲🌲🌲🌲🌲🌲🌲🌲🌲🌲🌲🌲🌲🌲🌲🌲🌲🌲🌲🌲🌲🌲🌲🌲🌲🌲🏔🏔🏔🏔🏔🏔🏔🌲🌲🌲🌲🌲🌲🌲🌲🌲🌲🌲🌲🌲🌲🏔🏔🏔🌲🌲🌲🌲🌲🌲🌲🌲🌲🌲🌲🌲🌲🌲🌲🌲🌲🌲🌲🌲🌲🌲🌲🌲🌲🌲
🌲🌲🌲🌲🌲🌲🏔🏔🏔🏔🏔🏔🏔🏔🏔🏔🏔🏔🌲🌲🌲🌲🌲🌲🌲🌲🌲🌲🌲🌲🌲🌲🌲🌲🌲🌲🌲🌲🌲🌲🌲🌲🌲🌲🌲🌲🌲🌲🌲🏔🏔🏔🏔🌲🌲🌲🏔🌲🌲🌲🌲🌲🌲🌲🌲🌲🌲🌲🌲🌲🌲🏔🏔🌲🌲🌲🌲🌲🌲🌲🌲🌲🌲🌲🌲🌲🌲🌲🌲🌲🌲🌲🌲🌲🌲🌲🌲🌲🌲🌲
🌲🌲🌲🌲🌲🌲🏔🏔🏔🏔🏔🏔🏔🏔🏔🏔🏔🏔🌲🌲🌲🌲🌲🌲🌲🌲🌲🌲🌲🌲🌲🌲🌲🌲🌲🌲🌲🌲🌲🌲🌲🌲🌲🌲🌲🌲🌲🌲🏔🏔🏔🏔🌲🌲🌲🌲🏔🌲🌲🌲🌲🌲🌲🌲🌲🌲🌲🌲🌲🌲🏔🏔🌲🌲🌲🌲🌲🌲🌲🌲🌲🌲🌲🌲🌲🌲🌲🌲🌲🌲🌲🌲🌲🌲🌲🌲🌲🌲🌲🌲
🌲🌲🌲🌲🌲🌲🏔🏔🏔🏔🏔🏔🏔🏔🏔🏔🏔🏔🌲🌲🌲🌲🌲🌲🌲🌲🌲🌲🌲🌲🌲🌲🌲🌲🌲🌲🌲🌲🌲🌲🌲🌲🌲🌲🌲🌲🌲🌲🏔🏔🏔🏔🌲🌲🌲🌲🏔🏔🌲🌲🌲🌲🌲🌲🌲🌲🌲🌲🌲🌲🏔🏔🌲🌲🌲🌲🌲🌲🌲🌲🌲🌲🌲🌲🌲🌲🌲🌲🌲🌲🌲🌲🌲🌲🌲🌲🌲🌲🌲🌲
🌲🌲🌲🌲🌲🌲🏔🏔🏔🏔🏔🏔🏔🏔🏔🏔🏔🏔🌲🌲🌲🌲🌲🌲🌲🌲🌲🌲🌲🌲🌲🌲🌲🌲🌲🌲🌲🌲🌲🌲🌲🌲🌲🌲🌲🌲🌲🌲🌲🏔🏔🏔🌲🌲🌲🌲🌲🌲🌲🌲🌲🌲🌲🌲🌲🌲🌲🌲🌲🌲🏔🏔🌲🌲🌲🌲🌲🌲🌲🏡🏡🏡🌲🌲🌲🌲🌲🌲🌲🌲🌲🌲🌲🌲🌲🌲🌲🌲🌲🌲
🌲🌲🌲🌲🌲🌲🏔🏔🏔🏔🏔🏔🏔🏔🏔🏔🏔🏔🏔🌲🌲🌲🏔🏔🏔🌲🌲🌲🌲🌲🌲🌲🌲🌲🌲🌲🌲🌲🌲🌲🌲🌲🌲🌲🌲🌲🌲🌲🌲🏔🏔🏔🏔🌲🌲🌲🌲🌲🌲🌲🌲🌲🌲🌲🌲🌲🌲🌲🌲🌲🏔🏔🌲🌲🌲🌲🌲🌲🏡🏡🏡🏡🏡🏡🏡🏡🏡🏡🌲🌲🌲🌲🌲🌲🌲🌲🌲🌲🌲🌲
🌲🌲🌲🌲🌲🌲🏔🏔🏔🏔🏔🏔🏔🏔🏔🏔🏔🏔🏔🏔🏔🏔🏔🏔🏔🏔🌲🌲🌲🌲🌲🌲🌲🌲🌲🌲🌲🌲🌲🌲🌲🌲🌲🌲🌲🌲🌲🌲🌲🏔🏔🏔🏔🌲🌲🌲🌲🌲🌲🌲🌲🌲🌲🌲🌲🌲🌲🌲🌲🏔🏔🏔🌲🌲🌲🌲🌲🌲🏡🏡🏡🏡🏡🏡🏡🏡🏡🏡🏡🏡🌲🌲🌲🌲🌲🌲🌲🌲🌲🌲
🏡🌲🌲🌲🌲🌲🌲🏔🏔🏔🏔🏔🏔🏔🏔🏔🏔🏔🏔🏔🏔🏔🏔🏔🏔🏔🏔🏔🏔🌲🌲🌲🌲🌲🌲🌲🌲🌲🌲🌲🌲🌲🌲🌲🌲🌲🌲🌲🌲🏔🏔🏔🌲🌲🌲🌲🌲🌲🌲🌲🌲🌲🌲🌲🌲🌲🌲🌲🌲🏔🏔🏔🌲🌲🌲🌲🌲🌲🏡🏡🏡🏡🏡🏡🏡🏡🏡🏡🏡🏡🏡🏡🌲🌲🌲🌲🏡🏡🏡🏡
🏡🏡🌲🌲🌲🌲🌲🌲🏔🏔🏔🏔🏔🏔🏔🏔🏔🏔🏔🏔🏔🏔🏔🏔🏔🏔🏔🏔🏔🏔🏔🌲🌲🌲🌲🌲🌲🌲🌲🌲🌲🌲🌲🌲🌲🌲🌲🌲🏔🏔🏔🏔🌲🌲🌲🌲🌲🌲🌲🌲🌲🌲🌲🌲🌲🌲🌲🌲🏔🏔🏔🌲🌲🌲🌲🌲🌲🌲🏡🏡🏡🏡🏡🏡🌲🌲🌲🌲🏡🏡🏡🏡🏡🏡🏡🏡🏡🏡🏡🏡
🏡🏡🌲🌲🌲🌲🌲🌲🌲🏔🏔🏔🏔🏔🏔🏔🏔🏔🏔🌲🌲🌲🌲🏔🏔🏔🏔🏔🏔🏔🏔🏔🌲🌲🌲🌲🌲🌲🌲🌲🌲🌲🌲🌲🌲🌲🌲🌲🏔🏔🏔🏔🌲🌲🌲🌲🌲🌲🌲🌲🌲🌲🌲🌲🌲🌲🌲🌲🏔🏔🏔🌲🌲🌲🌲🌲🌲🏡🏡🏡🏡🌲🌲🌲🌲🌲🌲🌲🌲🌲🏡🏡🏡🏡🏡🏡🏡🏡🏡🏡
🏡🏡🌲🌲🌲🌲🌲🌲🌲🏔🏔🏔🏔🏔🏔🏔🏔🏔🌲🌲🌲🌲🌲🌲🌲🌲🏔🏔🏔🏔🏔🏔🌲🌲🌲🌲🌲🌲🌲🌲🌲🌲🌲🌲🌲🌲🏔🏔🏔🏔🏔🏔🏔🌲🌲🌲🌲🌲🌲🌲🌲🌲🌲🌲🌲🌲🌲🏔🏔🏔🏔🌲🌲🌲🌲🌲🌲🏡🏡🏡🌲🌲🌲🌲🌲🌲🌲🌲🌲🌲🌲🏡🏡🏡🏡🏡🏡🏡🏡🏡
🏡🌲🌲🌲🌲🌲🌲🌲🌲🏔🏔🏔🏔🏔🏔🌲🏔🏔🌲🌲🌲🌲🌲🌲🌲🌲🌲🌲🌲🌲🏔🏔🏔🌲🌲🌲🌲🌲🌲🌲🌲🌲🌲🌲🌲🏔🏔🏔🏔🏔🏔🏔🏔🌲🌲🌲🌲🏔🌲🌲🌲🌲🌲🌲🌲🌲🏔🏔🏔🏔🏔🌲🌲🌲🌲🌲🌲🏡🏡🏡🌲🌲🌲🌲🌲🌲🌲🌲🌲🌲🌲🌲🌲🏡🏡🏡🏡🏡🌲🌲
🏡🌲🌲🌲🌲🌲🌲🌲🏔🏔🏔🏔🏔🏔🌲🌲🌲🌲🌲🌲🌲🌲🌲🌲🌲🌲🌲🌲🌲🌲🏔🏔🏔🌲🌲🌲🌲🌲🌲🌲🌲🌲🌲🌲🌲🏔🏔🏔🏔🏔🏔🏔🏔🌲🌲🌲🌲🌲🌲🌲🌲🌲🌲🌲🌲🏔🏔🏔🏔🏔🏔🌲🌲🌲🌲🌲🏡🏡🏡🌲🌲🌲🌲🌲🌲🌲🌾🌾🌾🌾🌾🌲🌲🌲🌲🌲🌲🌲🌲🌲
🏡🏡🌲🌲🌲🌲🌲🌲🏔🏔🏔🏔🏔🏔🌲🌲🌲🌲🌲🌲🌲🌲🌲🌲🌲🌲🌲🌲🌲🌲🌲🏔🏔🌲🌲🌲🌲🌲🌲🌲🌲🌲🌲🌲🏔🏔🏔🏔🏔🏔🏔🌲🌲🌲🌲🌲🌲🌲🌲🌲🌲🌲🌲🌲🏔🏔🏔🏔🏔🏔🌲🌲🌲🌲🌲🌲🏡🏡🏡🌲🌲🌲🌲🌲🌲🌾🌾🌾🌾🌾🌾🌾🌾🌲🌲🌲🌲🌲🌲🌲
🏡🏡🌲🌲🌲🌲🌲🌲🏔🏔🏔🏔🏔🏔🌲🌲🌲🌲🌲🌲🌲🌲🌲🌲🌲🌲🌲🌲🌲🌲🌲🏔🏔🏔🌲🌲🌲🌲🌲🌲🏔🏔🏔🏔🏔🏔🏔🏔🌲🌲🌲🌲🌲🌲🌲🌲🌲🌲🌲🌲🌲🌲🌲🌲🏔🏔🏔🏔🏔🌲🌲🌲🌲🌲🌲🌲🏡🏡🏡🌲🌲🌲🌲🌲🌲🌾🌾🌾🌾🌾🌾🌾🌾🌾🌾🌲🌲🌲🌲🌲
🏡🏡🏡🌲🌲🌲🌲🌲🏔🏔🏔🏔🏔🌲🌲🌲🌲🌲🌲🌲🌲🌲🌲🌲🌲🌲🌲🌲🌲🌲🌲🏔🏔🏔🌲🌲🌲🏔🏔🏔🏔🏔🏔🏔🏔🏔🏔🌲🌲🌲🌲🌲🌲🌲🌲🌲🌲🌲🌲🌲🌲🌲🌲🌲🏔🏔🏔🌲🌲🌲🌲🌲🌲🌲🌲🏡🏡🏡🌲🌲🌲🌲🌲🌲🌲🌾🌾🌾🌾🌾🌾🌾🌾🌾🌾🌾🌾🌾🌲🌲
🏡🏡🏡🌲🌲🌲🌲🌲🏔🏔🏔🏔🏔🌲🌲🌲🌲🌲🌲🌲🌲🌲🌲🌲🌲🌲🌲🌲🌲🌲🏔🏔🏔🏔🏔🏔🏔🏔🏔🏔🏔🏔🏔🏔🏔🏔🌲🌲🌲🌲🌲🌲🌲🌲🌲🌲🌲🌲🌲🌲🌲🌲🌲🌲🏔🏔🏔🌲🌲🌲🌲🌲🌲🌲🌲🏡🏡🌲🌲🌲🌲🌲🌲🌲🌾🌾🌾🌾🌾🌾🌾🌴🌴🌾🌾🌾🌾🌾🌾🌾
🏡🏡🏡🌲🌲🌲🌲🌲🏔🏔🏔🏔🌲🌲🌲🌲🌲🌲🌲🌲🌲🌲🌲🌲🌲🌲🌲🌲🌲🏔🏔🏔🏔🏔🌲🏔🏔🏔🏔🏔🏔🏔🏔🏔🏔🌲🌲🌲🌲🌲🌲🌲🌲🌲🌲🌲🌲🌲🌲🌲🌲🌲🌲🌲🌲🏔🏔🌲🌲🌲🌲🌲🌲🌲🏡🏡🏡🌲🌲🌲🌲🌲🌲🌲🌾🌾🌾🌾🌾🌾🌾🌴🌴🌴🌾🌾🌾🌾🌾🌾
🌲🌲🌲🌲🌲🌲🌲🌲🏔🏔🏔🏔🌲🌲🌲🌲🌲🌲🌲🌲🌲🌲🌲🌲🌲🌲🌲🏔🏔🏔🏔🏔🏔🏔🌲🌲🏔🏔🏔🏔🏔🏔🏔🌲🌲🌲🌲🌲🌲🌲🌲🌲🌲🌲🌲🌲🌲🌲🌲🌲🌲🌲🌲🌲🌲🏔🏔🌲🌲🌲🌲🌲🌲🌲🏡🏡🌲🌲🌲🌲🌲🌲🌲🌾🌾🌾🌾🌾🌾🌾🌾🌴🌴🌴🌴🌾🌾🌾🌾🌾
🌲🌲🌲🌲🌲🌲🌲🌲🏔🏔🏔🏔🌲🌲🌲🌲🌲🌲🌲🌲🌲🌲🌲🌲🌲🌲🌲🏔🏔🏔🏔🏔🏔🌲🌲🌲🌲🌲🏔🏔🏔🏔🏔🌲🌲🌲🌲🌲🌲🌲🌲🌲🌲🌲🌲🌲🌲🌲🌲🌲🌲🌲🌲🌲🏔🏔🏔🌲🌲🌲🌲🌲🌲🏡🏡🌲🌲🌲🌾🌾🌾🌾🌾🌾🌾🌾🌾🌾🌾🌾🌴🌴🌴🌴🌴🌾🌾🌾🌾🌾
🌲🌲🌲🌲🌲🌲🌲🏔🏔🏔🏔🏔🏔🌲🌲🌲🌲🌲🌲🌲🌲🌲🌲🌲🌲🌲🌲🏔🏔🏔🏔🏔🏔🌲🌲🌲🌲🌲🌲🏔🏔🏔🏔🏔🌲🌲🌲🌲🌲🌲🌲🌲🌲🌲🌲🌲🌲🌲🌲🌲🌲🌲🌲🌲🏔🏔🏔🌲🌲🌲🌲🌲🌲🏡🏡🌲🌲🌲🌾🌾🌾🌾🌾🌾🌾🌾🌾🌾🌾🌾🌴🌴🌴🌴🌴🌾🌾🌾🌾🌾
🌲🌲🌲🌲🌲🌲🌲🏔🏔🏔🏔🏔🏔🌲🌲🌲🌲🌲🌲🌲🌲🌲🌲🌲🌲🌲🌲🏔🏔🏔🏔🏔🌲🌲🌲🌲🌲🌲🌲🌲🏔🏔🏔🏔🌲🌲🌲🌲🌲🌲🌲🌲🌲🌲🌲🌲🌲🌲🌲🌲🌲🌲🏔🏔🏔🏔🏔🌲🌲🌲🌲🌲🏡🏡🌲🌲🌲🌾🌾🌾🌾🌾🌾🌾🌾🌾🌾🌾🌾🌴🌴🌴🌴🌴🌴🌾🌾🌾🌾🌾
🌲🌲🌲🌲🌲🌲🏔🏔🏔🏔🏔🏔🏔🌲🌲🌲🌲🌲🌲🌲🌲🌲🌲🌲🌲🌲🏔🏔🏔🏔🏔🏔🌲🌲🌲🌲🌲🌲🌲🌲🏔🏔🏔🏔🏔🌲🌲🌲🌲🌲🌲🌲🌲🌲🌲🌲🌲🌲🌲🌲🌲🏔🏔🏔🏔🏔🏔🌲🌲🌲🌲🌲🏡🏡🌲🌲🌾🌾🌾🌾🌾🌾🌾🌾🌾🌾🌾🌾🌴🌴🌴🌴🌴🌴🌴🌴🌾🌾🌾🌾
🌲🌲🌲🌲🌲🌲🏔🏔🏔🏔🌲🌲🌲🌲🌲🌲🌲🌲🌲🌲🌲🌲🌲🌲🌲🌲🏔🏔🏔🏔🏔🏔🌲🌲🌲🌲🌲🌲🌲🌲🌲🏔🏔🏔🏔🏔🌲🌲🌲🌲🌲🌲🌲🌲🌲🌲🌲🌲🌲🌲🌲🏔🏔🏔🏔🏔🌲🌲🌲🌲🌲🌲🏡🌲🌲🌲🌾🌾🌾🌾🌾🌾🌾🌾🌾🌾🌾🌴🌴🌴🌴🌴🌴🌴🌴🌴🌴🌾🌾🌾
🌲🌲🌲🌲🌲🏔🏔🏔🏔🌲🌲🌲🌲🌲🌲🌲🌲🌲🌲🌲🌲🌲🌲🌲🌲🏔🏔🏔🏔🏔🏔🏔🏔🌲🌲🌲🌲🌲🌲🌲🌲🌲🏔🏔🏔🏔🌲🌲🌲🌲🏔🏔🏔🏔🏔🏔🏔🏔🏔🏔🏔🏔🏔🏔🏔🌲🌲🌲🌲🌲🌲🏡🏡🌲🌲🌾🌾🌾🌾🌾🌾🌾🌾🌾🌾🌴🌴🌴🌴🌴🌴🌴🌴🌴🌴🌴🌴🌾🌾🌾
🌲🌲🌲🌲🏔🏔🏔🏔🏔🌲🌲🌲🌲🌲🌲🌲🌲🌲🌲🌲🌲🌲🌲🌲🌲🌲🏔🏔🏔🏔🏔🏔🏔🏔🌲🌲🌲🌲🌲🌲🌲🌲🌲🏔🏔🏔🏔🏔🏔🏔🏔🏔🏔🏔🏔🏔🏔🏔🏔🏔🏔🏔🏔🏔🌲🌲🌲🌲🌲🌲🏡🏡🏡🌲🌲🌾🌾🌾🌾🌾🌴🌴🌴🌴🌴🌴🌴🌴🌴🌴🌴🌴🌴🌴🌴🌴🌴🌴🌾🌾
🌲🌲🌲🏔🏔🏔🏔🏔🌲🌲🌲🌲🌲🌲🌲🌲🌲🌲🌲🌲🌲🌲🌲🌲🌲🌲🌲🏔🏔🏔🏔🏔🏔🏔🏔🌲🌲🌲🌲🌲🌲🌲🌲🌲🏔🏔🏔🏔🏔🏔🏔🏔🏔🌲🌲🏔🏔🏔🏔🏔🏔🌲🌲🌲🌲🌲🌲🌲🌲🌲🏡🏡🌲🌲🌲🌾🌾🌾🌴🌴🌴🌴🌴🌴🌴🌴🌴🌴🌴🌴🌴🌴🌴🌴🌴🌴🌴🌾🌾🌾
🌲🌲🌲🏔🏔🏔🏔🌲🌲🌲🌲🌲🌲🌲🌲🌲🌲🌲🌲🌲🌲🌲🌲🌲🌲🌲🌲🌲🏔🏔🏔🏔🏔🏔🏔🏔🌲🌲🌲🌲🌲🌲🌲🌲🌲🏔🏔🏔🏔🏔🏔🏔🌲🌲🌲🌲🌲🌲🌲🌲🌲🌲🌲🌲🌲🌲🌲🌲🏡🏡🏡🏡🌲🌲🌲🌾🌾🌾🌴🌴🌴🌴🌴🌴🌴🌴🌴🌴🌴🌴🌴🌴🌴🌾🌾🌾🌾🌾🌾🌾
🌲🏔🏔🏔🏔🏔🌲🌲🌲🌲🌲🌲🌲🌲🌲🌲🌲🌲🌲🌲🌲🌲🌲🌲🌲🌲🌲🌲🌲🏔🏔🏔🏔🏔🏔🏔🌲🌲🌲🌲🌲🌲🌲🌲🌲🌲🌲🏔🏔🏔🏔🌲🌲🌲🌲🌲🌲🌲🌲🌲🌲🌲🌲🌲🌲🌲🌲🏡🏡🏡🏡🌲🌲🌲🌲🌾🌾🌾🌴🌴🌴🌴🌴🌴🌴🌴🌴🌴🌴🌴🌴🌴🌾🌾🌾🌾🌾🌾🌾🌾
🏔🏔🏔🏔🏔🌲🌲🌲🌲🌲🌲🌲🌲🌲🌲🌲🌲🌲🌲🌲🌲🌲🌲🌲🌲🌲🌲🌲🌲🌲🏔🏔🏔🏔🏔🏔🌲🌲🌲🌲🌲🌲🌲🌲🌲🌲🌲🌲🏔🏔🌲🌲🌲🌲🌲🌲🌲🌲🌲🌲🌲🌲🌲🌲🌲🏡🏡🏡🏡🏡🌲🌲🌲🌲🌲🌾🌾🌴🌴🌴🌴🌴🌴🌴🌴🌴🌴🌴🌴🌴🌴🌴🌾🌾🌾🌾🌾🌾🌾🌾
🏔🏔🏔🏔🌲🌲🌲🌲🌲🌲🌲🌲🌲🌲🌲🌲🌲🌲🌲🌲🌲🌲🌲🌲🌲🌲🌲🌲🌲🌲🌲🏔🏔🏔🏔🏔🌲🌲🌲🌲🌲🌲🌲🌲🌲🌲🌲🌲🌲🌲🌲🌲🌲🌲🌲🌲🌲🌲🌲🌲🌲🌲🌲🌲🌲🏡🏡🏡🏡🌲🌲🌲🌲🌲🌾🌾🌾🌴🌴🌴🌴🌴🌴🌴🌴🌴🌴🌴🌴🌴🌴🌾🌾🌾🌾🌾🌾🌾🌾🌾
🏔🏔🏔🌲🌲🌲🌲🌲🌲🌲🌲🌲🌲🌲🌲🌲🌲🌲🌲🌲🌲🌲🌲🌲🌲🌲🌲🌲🌲🌲🌲🌲🏔🏔🏔🏔🌲🌲🌲🌲🌲🌲🌲🌲🌲🌲🌲🌲🌲🌲🌲🌲🌲🌲🌲🌲🌲🌲🌲🌲🌲🌲🌲🌲🏡🏡🏡🏡🏡🌲🌲🌲🌲🌾🌾🌾🌴🌴🌴🌴🌴🌴🌴🌴🌴🌴🌴🌴🌴🌴🌴🌾🌾🌾🌾🌾🌾🌾🌾🌾
🏔🌲🌲🌲🌲🌲🌲🌲🌲🌲🌲🌲🌲🌲🌲🌲🌲🌲🌲🌲🌲🌲🌲🌲🌲🌲🌲🌲🌲🌲🌲🌲🏔🏔🏔🏔🌲🌲🌲🌲🌲🌲🌲🌲🌲🌲🌲🌲🌲🌲🌲🌲🌲🌲🌲🌲🌲🌲🌲🌲🌲🌲🌲🏡🏡🏡🏡🏡🏡🌲🌲🌲🌾🌾🌾🌴🌴🌴🌴🌴🌴🌴🌴🌴🌴🌴🌴🌴🌴🌴🌴🌾🌾🌾🌾🌾🌾🌾🌾🌾
🌲🌲🌲🌲🌲🌲🌲🌲🌲🌲🌲🌲🌲🌲🌲🌲🌲🌲🌲🌲🌲🌲🌲🌲🌲🌲🌲🌲🌲🌲🌲🌲🏔🏔🏔🏔🌲🌲🌲🌲🌲🌲🌲🌲🌲🌲🌲🌲🌲🌲🌲🌲🌲🌲🌲🌲🌲🌲🌲🌲🌲🌲🌲🏡🏡🏡🏡🏡🏡🌲🌲🌲🌾🌾🌴🌴🌴🌴🌴🌴🌴🌴🌴🌴🌴🌴🌴🌴🌴🌴🌾🌾🌾🌾🌾🌾🌾🌾🌾🌾
🌲🌲🌲🌲🌲🌲🌲🌲🌲🌲🌲🌲🌲🌲🌲🌲🌲🌲🌲🌲🌲🌲🌲🌲🌲🌲🌲🌲🌲🌲🌲🌲🌲🏔🏔🏔🌲🌲🌲🌲🌲🌲🌲🌲🌲🌲🌲🌲🌲🌲🌲🌲🌲🌲🌲🌲🌲🌲🌲🌲🌲🌲🏡🏡🏡🏡🏡🏡🌲🌲🌲🌾🌾🌾🌴🌴🌴🌴🌴🌴🌴🌴🌴🌴🌴🌴🌴🌴🌴🌴🌾🌾🌾🌾🌾🌾🌾🌾🌾🌾
🌲🌲🌲🌲🌲🌲🌲🌲🌲🌲🌲🌲🌲🌲🌲🌲🌲🌲🌲🌲🌲🌲🌲🌲🌲🌲🌲🌲🌲🌲🌲🌲🌲🏔🏔🏔🌲🌲🌲🌲🌲🌲🌲🌲🌲🌲🌲🌲🌲🌲🌲🌲🌲🌲🌲🌲🌲🌲🌲🌲🌲🌲🏡🏡🏡🏡🏡🏡🌲🌲🌲🌾🌾🌴🌴🌴🌴🌴🌴🌴🌴🌴🌴🌴🌴🌴🌴🌴🌴🌾🌾🌾🌾🌾🌾🌾🌾🌾🌾🌲
🌲🌲🌲🌲🌲🌲🌲🌲🌲🌲🌲🌲🌲🌲🌲🌲🌲🌲🌲🌲🌲🌲🌲🌲🌲🌲🌲🌲🌲🌲🌲🌲🌲🌲🏔🏔🌲🌲🌲🌲🌲🌲🌲🌲🌲🌲🌲🌲🌲🌲🌲🌲🌲🌲🌲🌲🌲🌲🏡🌲🌲🏡🏡🏡🏡🏡🏡🌲🌲🌲🌲🌾🌾🌴🌴🌴🌴🌴🌴🌴🌴🌴🌴🌴🌴🌴🌴🌴🌴🌾🌾🌾🌾🌾🌾🌾🌾🌾🌲🌲
🌲🌲🌲🌲🌲🌲🌲🌲🌲🌲🌲🌲🌲🌲🌲🌲🌲🌲🌲🌲🌲🌲🌲🌲🌲🌲🌲🌲🌲🌲🌲🌲🌲🌲🏔🏔🏔🌲🌲🌲🌲🌲🌲🌲🌲🌲🌲🌲🌲🌲🌲🌲🌲🌲🌲🌲🌲🏡🏡🏡🏡🏡🏡🏡🏡🏡🌲🌲🌲🌲🌾🌾🌾🌴🌴🌴🌴🌴🌴🌴🌴🌴🌴🌴🌴🌴🌴🌴🌴🌾🌾🌾🌾🌾🌾🌾🌲🌲🌲🌲
🌲🌲🌲🌲🌲🌲🌲🌲🌲🌲🌲🌲🌲🌲🌲🌲🌲🌲🌲🏢🏢🏢🌲🌲🌲🌲🌲🌲🌲🌲🌲🌲🌲🌲🌲🏔🏔🌲🌲🌲🌲🌲🌲🌲🌲🌲🌲🌲🌲🌲🌲🌲🌲🌲🏡🏡🏡🏡🏡🏡🏡🏡🏡🏡🏡🌲🌲🌲🌲🌲🌾🌾🌴🌴🌴🌴🌴🌴🌴🌴🌴🌴🌴🌴🌴🌴🌴🌴🌾🌾🌾🌾🌾🌾🌾🌾🌲🌲🌲🌲
🌲🌲🌲🌲🌲🌲🌲🌲🌲🌲🌲🌲🌲🌲🌲🌲🌲🌲🏢🏢🏢🏢🏢🌲🌲🌲🌲🌲🌲🌲🌲🌲🌲🌲🌲🏔🏔🌲🌲🌲🌲🌲🌲🌲🌲🌲🌲🌲🌲🌲🌲🏡🏡🏡🏡🏡🏡🏡🏡🏡🏡🏡🏡🏡🌲🌲🌲🌲🌲🌾🌾🌾🌴🌴🌴🌴🌴🌴🌴🌴🌴🌴🌴🌴🌴🌴🌴🌴🌾🌾🌾🌾🌾🌾🌾🌾🌲🌲🌲🌲
🌲🌲🌲🌲🌲🌲🌲🌲🌲🌲🌲🌲🌲🌲🌲🌲🌲🏢🏢🏢🏢🏢🏢🌲🌲🌲🌲🌲🌲🌲🌲🌲🌲🌲🌲🏔🏔🏔🌲🌲🌲🌲🌲🌲🌲🌲🌲🌲🌲🌲🏡🏡🏡🏡🏡🏡🏡🏡🏡🏡🏡🏡🏡🏡🌲🌲🌲🌲🌾🌾🌾🌾🌴🌴🌴🌴🌴🌴🌴🌴🌴🌴🌴🌴🌴🌴🌴🌾🌾🌾🌾🌾🌾🌾🌾🌲🌲🌲🌲🏡
🌲🌲🌲🌲🌲🌲🌲🌲🌲🌲🌲🌲🌲🌲🌲🌲🏢🏢🏢🏢🏢🏢🌲🌲🌲🌲🌲🌲🌲🌲🌲🌲🌲🌲🌲🌲🏔🏔🌲🌲🌲🌲🌲🌲🌲🌲🌲🌲🌲🏡🏡🏡🏡🏡🏡🌲🌲🌲🌲🌲🌲🏡🏡🌲🌲🌲🌲🌲🌾🌾🌾🌴🌴🌴🌴🌴🌴🌴🌴🌴🌴🌴🌴🌴🌴🌴🌾🌾🌾🌾🌾🌾🌾🌾🌾🌲🌲🌲🏡🏡
🌲🌲🌲🌲🌲🌲🌲🌲🌲🌲🌲🌲🌲🌲🌲🌲🏢🏢🏢🏢🏢🏢🌲🌲🌲🌲🌲🌲🌲🌲🌲🌲🌲🌲🌲🌲🏔🏔🌲🌲🌲🌲🌲🌲🌲🌲🌲🌲🌲🏡🏡🏡🏡🏡🌲🌲🌲🌲🌲🌲🌲🌲🌲🌲🌲🌲🌲🌲🌾🌾🌾🌴🌴🌴🌴🌴🌴🌴🌴🌴🌴🌴🌴🌴🌴🌴🌾🌾🌾🌾🌾🌾🌾🌾🌲🌲🌲🏡🏡🏡
🌲🌲🌲🌲🌲🌲🌲🌲🌲🌲🌲🌲🌲🌲🌲🏢🏢🏢🏢🏢🏢🌲🌲🌲🌲🌲🌲🌲🌲🌲🌲🌲🌲🌲🌲🌲🏔🏔🌲🌲🌲🌲🌲🌲🌲🌲🌲🌲🌲🏡🏡🏡🏡🏡🌲🌲🌲🌲🌲🌲🌲🌲🌲🌲🌲🌲🌲🌲🌾🌾🌾🌾🌴🌴🌴🌴🌴🌴🌴🌴🌴🌴🌴🌴🌴🌾🌾🌾🌾🌾🌲🌲🌲🌲🌲🌲🏡🏡🏡🌲
🌲🌲🌲🌲🌲🌲🌲🌲🌲🌲🌲🌲🌲🌲🏢🏢🏢🏢🏢🏢🌲🌲🌲🌲🌲🌲🌲🌲🌲🌲🌲🌲🌲🌲🌲🌲🏔🏔🌲🌲🌲🌲🌲🌲🌲🌲🌲🌲🌲🏡🏡🏡🏡🏡🏡🌲🌲🌲🌲🌲🌲🌲🌲🌲🌲🌲🌲🌲🌾🌾🌾🌾🌴🌴🌴🌴🌴🌴🌴🌴🌴🌴🌴🌴🌴🌾🌾🌾🌾🌲🌲🌲🌲🌲🌲🏡🏡🏡🌲🌲
🌲🌲🌲🌲🌲🌲🌲🌲🌲🌲🌲🌲🌲🌲🏢🏢🏢🏢🏢🏢🌲🌲🌲🌲🌲🌲🌲🌲🌲🌲🌲🌲🌲🌲🌲🌲🏔🏔🏔🌲🌲🌲🌲🌲🌲🌲🌲🌲🌲🌲🏡🏡🏡🏡🏡🌲🌲🌲🌲🌲🌲🌲🌲🌲🌲🌲🌲🌲🌲🌾🌾🌾🌴🌴🌴🌴🌴🌴🌴🌴🌴🌴🌴🌴🌾🌾🌾🌾🌲🌲🌲🌲🌲🏡🏡🏡🏡🌲🌲🌲
🌲🌲🌲🌲🌲🌲🌲🌲🌲🌲🌲🌲🌲🏢🏢🏢🏢🏢🏢🌲🌲🌲🌲🌲🌲🌲🌲🌲🌲🌲🌲🌲🌲🌲🌲🌲🌲🏔🏔🌲🌲🌲🌲🌲🌲🌲🌲🌲🌲🌲🌲🏡🏡🏡🏡🌲🌲🌲🌲🌲🌲🌲🌲🌲🌲🌲🌲🌲🌲🌾🌾🌾🌾🌴🌴🌴🌴🌴🌴🌴🌴🌴🌴🌾🌾🌾🌾🌾🌲🌲🌲🌲🏡🏡🏡🌲🌲🌲🌲🌲
🌲🌲🌲🌲🌲🌲🌲🌲🌲🌲🌲🌲🏢🏢🏢🏢🏢🏢🏢🌲🌲🌲🌲🌲🌲🌲🌲🌲🌲🌲🌲🌲🌲🌲🌲🌲🌲🏔🏔🏔🌲🌲🌲🌲🌲🌲🌲🌲🌲🌲🌲🌲🏡🏡🏡🏡🌲🌲🌲🌲🌲🌲🌲🌲🌲🌲🌲🌲🌲🌾🌾🌾🌾🌴🌴🌴🌴🌴🌴🌴🌴🌴🌾🌾🌾🌾🌾🌲🌲🌲🌲🏡🏡🏡🌲🌲🌲🌲🌲🌲
🌲🌲🌲🌲🌲🌲🌲🌲🌲🌲🌲🏢🏢🏢🏢🏢🏢🏢🏢🌲🌲🌲🌲🌲🌲🌲🌲🌲🌲🌲🌲🌲🌲🌲🌲🌲🌲🏔🏔🏔🌲🌲🌲🌲🌲🌲🌲🌲🌲🌲🌲🌲🌲🏡🏡🏡🌲🌲🌲🌲🌲🌲🌲🌲🌲🌲🌲🌲🌲🌲🌾🌾🌾🌾🌴🌴🌴🌴🌴🌴🌴🌾🌾🌾🌾🌾🌲🌲🌲🌲🌲🏡🏡🏡🌲🌲🌲🌲🌲🌲
🌲🌲🌲🌲🌲🌲🌲🌲🌲🌲🌲🏢🏢🏢🏢🌲🌲🌲🌲🌲🌲🌲🌲🌲🌲🌲🌲🌲🌲🌲🌲🌲🌲🌲🌲🌲🏔🏔🏔🏔🌲🌲🌲🌲🌲🌲🌲🌲🌲🌲🌲🌲🌲🌲🏡🏡🏡🌲🌲🌲🌲🌲🌲🌲🌲🌲🌲🌲🌲🌲🌲🌲🌾🌾🌾🌴🌴🌴🌴🌴🌾🌾🌾🌾🌾🌲🌲🌲🌲🌲🌲🏡🏡🏡🌲🌲🌲🌲🌲🌲
🌲🌲🌲🌲🌲🌲🌲🌲🌲🌲🌲🏢🏢🏢🌲🌲🌲🌲🌲🌲🌲🌲🌲🌲🌲🌲🌲🌲🌲🌲🌲🌲🌲🌲🌲🌲🏔🏔🏔🏔🏔🌲🌲🌲🌲🏔🌲🌲🌲🌲🌲🌲🌲🌲🌲🏡🏡🏡🏡🏡🌲🌲🌲🌲🌲🌲🌲🌲🌲🌲🌲🌲🌲🌾🌾🌾🌾🌾🌾🌾🌾🌾🌾🌾🌾🌲🌲🌲🌲🌲🌲🏡🏡🏡🌲🌲🌲🌲🌲🌲
🌲🌲🌲🌲🌲🌲🌲🌲🌲🌲🌲🏢🏢🏢🌲🌲🌲🌲🌲🌲🌲🌲🌲🌲🌲🌲🌲🌲🌲🌲🌲🌲🌲🌲🌲🌲🏔🏔🏔🏔🏔🏔🏔🏔🏔🏔🏔🏔🌲🌲🌲🌲🌲🌲🌲🌲🌲🏡🏡🏡🏡🏡🏡🏡🌲🌲🌲🌲🌲🌲🌲🌲🌲🌲🌲🌾🌾🌾🌾🌾🌾🌾🌾🌾🌾🌲🌲🌲🌲🌲🌲🏡🏡🏡🌲🌲🌲🌲🌲🌲
🌲🌲🌲🌲🌲🌲🌲🌲🌲🌲🌲🏢🏢🏢🌲🌲🌲🌲🌲🌲🌲🌲🌲🌲🌲🌲🌲🌲🌲🌲🌲🌲🌲🌲🌲🌲🌲🏔🏔🏔🏔🏔🏔🏔🏔🏔🏔🏔🏔🏔🌲🌲🌲🌲🌲🌲🌲🌲🌲🌲🏡🏡🏡🏡🏡🏡🌲🌲🌲🌲🌲🌲🌲🌲🌲🌲🌾🌾🌾🌾🌾🌾🌾🌾🌾🌲🌲🌲🌲🌲🌲🏡🏡🏡🏡🌲🌲🌲🌲🌲
🌲🌲🌲🌲🌲🌲🌲🌲🌲🌲🌲🌲🌲🌲🌲🌲🌲🌲🌲🌲🌲🌲🌲🌲🌲🌲🌲🌲🌲🌲🌲🌲🌲🌲🌲🌲🌲🌲🌲🏔🏔🏔🏔🏔🏔🏔🏔🏔🏔🏔🏔🌲🌲🌲🌲🌲🌲🌲🌲🌲🌲🌲🏡🏡🏡🏡🏡🌲🌲🌲🌲🌲🌲🌲🌲🌲🌲🌲🌾🌾🌾🌾🌾🌾🌾🌲🌲🌲🌲🌲🌲🏡🏡🏡🏡🌲🌲🌲🌲🌲
🌲🌲🌲🌲🌲🌲🌲🌲🌲🌲🌲🌲🌲🌲🌲🌲🌲🌲🌲🌲🌲🌲🌲🌲🌲🌲🌲🌲🌲🌲🌲🌲🌲🌲🌲🌲🌲🌲🌲🌲🌲🏔🏔🏔🏔🏔🏔🏔🏔🏔🏔🏔🌲🌲🌲🌲🌲🌲🌲🌲🌲🌲🌲🏡🏡🏡🏡🏡🏡🌲🌲🌲🌲🌲🌲🌲🌲🌲🌲🌾🌾🌾🌾🌾🌲🌲🌲🌲🌲🌲🌲🏡🏡🏡🏡🌲🌲🌲🌲🌲
🏔🏔🏔🌲🌲🌲🌲🌲🌲🌲🌲🌲🌲🌲🌲🌲🌲🌲🌲🌲🌲🌲🌲🌲🌲🌲🌲🌲🌲🌲🌲🌲🌲🌲🌲🌲🌲🌲🌲🌲🌲🌲🏔🏔🏔🏔🏔🏔🏔🏔🏔🏔🌲🌲🌲🌲🌲🌲🌲🌲🌲🌲🌲🌲🏡🏡🏡🏡🏡🏡🌲🌲🌲🌲🌲🌲🌲🌲🌲🌲🌾🌾🌾🌲🌲🌲🌲🌲🌲🌲🌲🏡🏡🏡🌲🌲🌲🌲🌲🌲
🏔🏔🏔🌲🌲🌲🌲🌲🌲🌲🌲🌲🌲🌲🌲🌲🌲🌲🌲🌲🌲🌲🌲🌲🌲🌲🌲🌲🌲🌲🌲🌲🌲🌲🌲🌲🌲🌲🌲🌲🌲🌲🌲🌲🌲🌲🌲🌲🏔🏔🏔🏔🌲🌲🌲🌲🌲🌲🌲🌲🌲🌲🌲🌲🏡🏡🏡🏡🏡🏡🏡🌲🌲🌲🌲🌲🌲🌲🌲🌾🌾🌾🌾🌲🌲🌲🌲🌲🌲🏡🏡🏡🏡🌲🌲🌲🌲🌲🌲🏔
