🏔🌲🏢🌴🌴🌴🏖🏖🌊🌊🌊🌊🌊🌊🌊🌊🌊🌊🌊🌊🏖🏖🏖🏖🏖🏖🌴🌴🌴🌴🏖🌊🌊🌊🌊🏖🌴🌴🏢🌲🌲🌲🏔🌲🌲🌲🌲🌲🏔🏔🏔🏔🌲🌲🌲🏡🌲🌲🌲🌲🌲🏢🏢🏢🏢🏢🏢🏢🌴🌴🏢🏢🌲🌲🏔🌲🌲🏡🌲🌴🌴🌴🌴🌴🌾🌾🌾🌲🏡🌲🌲🌲🌲🌲🌲🌲🌲🌲🌲🏔
🌲🌴🌴🏖🌊🌊🌊🌊🌊🌊🌊🌊🌊🌊🌊🌊🏖🌊🌊🌊🌊🌊🌊🌊🌊🌊🌊🏖🏖🏖🌊🌊🌊🌊🌊🌊🏖🌴🌴🏢🌲🌲🌲🌲🌲🌲🌲🌲🌲🌲🌲🌲🏔🏔🌲🌲🌲🏔🌲🌲🏢🏢🏢🌴🌴🏢🌴🌴🌴🌴🌴🏢🌲🌲🏔🏔🌲🏡🌲🌾🌴🌴🌴🌴🌾🌾🌲🏡🌲🌲🌲🌲🌲🌲🌲🌲🌲🌲🌲🌲
🏢🌴🌊🌊🌊🌊🏖🌴🌴🌴🏖🏖🏖🏖🏖🌴🌴🌴🏖🌊🌊🌊🌊🌊🌊🌊🌊🌊🌊🌊🌊🌊🌊🌊🌊🌊🌊🏖🌴🌴🏢🌲🌲🌲🌲🌲🌲🌲🌲🌲🌲🌲🌲🌲🏔🏔🏔🏔🌲🌲🏢🌴🌴🌴🌴🌴🌴🌴🌴🌴🌴🌴🏢🌲🌲🏔🏔🌲🏡🌾🌴🌴🌴🌴🌾🌲🏡🌲🌲🏔🏔🏔🏔🏔🏔🏔🌲🌲🌲🌲
🌴🏖🌊🌊🏖🌴🌴🌴🌴🌴🌴🌴🌴🌴🌴🌴🌴🌴🌴🏖🌊🌊🌊🌊🌊🌊🌊🌊🌊🌊🌊🌊🌊🌊🌊🌊🌊🌊🏖🌴🌴🌲🌲🌲🌲🏢🏢🏢🌲🌲🌲🌲🌲🌲🌲🌲🌲🌲🌲🌲🏢🌴🌴🌴🌴🌴🌴🌴🌴🌴🌴🌴🏢🌲🌲🌲🌲🏔🌲🌲🌾🌴🌴🌴🌾🌲🏡🌲🌲🏔🌲🌲🌲🏔🏔🏔🏔🏔🏔🏔
🌴🌊🌊🏖🌴🌴🌾🌾🌲🌲🌲🌲🌲🌾🌲🌲🌲🌾🌴🌴🌴🌊🌊🌊🏖🏖🏖🏖🏖🌊🌊🌊🌊🌊🌊🌊🌊🌊🏖🌴🌴🏢🌲🌲🏢🏢🏢🏢🏢🏢🏢🏢🏢🏢🌲🌲🌲🌲🌲🌲🌲🌴🌴🌴🏖🏖🏖🏖🏖🌴🌴🌴🌴🏢🌲🌲🌲🌲🌲🏡🌲🌾🌴🌴🌾🌲🏡🌲🌲🏔🌲🌲🌲🌲🌲🌲🌲🌲🌲🌲
🌴🌊🌊🌴🌴🌾🌲🌲🏡🌲🌲🌲🌲🌲🌲🌲🌲🌲🏡🌾🌴🌴🏖🏖🌴🌴🌴🌴🌴🌴🌴🌴🌴🏖🌊🌊🌊🌊🌊🌴🌴🌴🏢🌲🏢🏢🌴🌴🏢🏢🌴🌴🌴🌴🌴🏢🌲🌲🌲🌲🌲🏢🌴🌴🏖🏖🏖🏖🏖🌴🌴🌴🌴🏢🏢🌲🌲🌲🌲🌲🏡🌲🌾🌾🌾🌲🏡🌲🌲🏔🌲🌲🌲🌲🌲🌲🌲🌲🌲🌲
🏖🌊🏖🌴🌴🌾🌲🏡🌲🌲🏔🏔🏔🌲🌲🏔🏔🏔🌲🌲🌲🌴🌴🌴🌴🌴🌴🌴🌴🌴🌴🌴🌴🌴🌴🌊🌊🌊🌊🏖🌴🌴🏢🏢🏢🌴🌴🌴🌴🌴🌴🌴🌴🌴🌴🌴🏢🌲🌲🌲🌲🏢🌴🌴🌴🏖🏖🏖🌴🌴🌴🌴🏢🏢🌲🌲🌲🌲🌲🌲🌲🏡🌲🌾🌾🌲🌲🏡🌲🌲🏔🌲🌲🌲🌲🌲🌲🌲🌲🌲
🏖🌊🏖🌴🌴🌾🌲🏡🌲🏔🌲🌲🌲🌲🌲🌲🌲🌲🌲🏔🌲🏡🌲🌾🌲🌲🌲🌲🌲🌲🌲🌾🌾🌴🌴🌴🏖🌊🌊🌊🏖🌴🌴🏢🌴🌴🌴🌴🌴🌴🌴🌴🌴🌴🌴🌴🌴🌴🏢🌲🏢🏢🌴🌴🌴🏖🌴🌴🌴🌴🌴🌴🏢🌲🌲🌲🌲🌲🌲🏔🌲🏡🌲🌲🌾🌾🌲🏡🌲🌲🏔🏔🌲🌲🌲🌲🌲🌲🌲🏢
🌊🌊🌴🌴🌴🌾🌲🌲🌲🏔🌲🌲🌲🌲🌲🌲🌲🌲🌲🌲🌲🌲🌲🌲🌲🌲🌲🌲🌲🌲🏡🏡🏡🌲🌾🌴🌴🏖🌊🌊🌊🌴🌴🌴🌴🌴🌴🌴🌴🌴🌴🌴🏖🏖🏖🌴🌴🌴🌴🏢🏢🌴🌴🌴🌴🌴🌴🌴🌴🌴🌴🏢🏢🌲🌲🌲🌲🌲🌲🏔🌲🏡🏡🌲🌾🌾🌲🌲🏡🌲🌲🏔🏔🏔🌲🌲🌲🌲🏢🏢
🌊🌊🌴🌴🌴🌾🏡🌲🌲🏔🌲🌲🌲🌲🌲🌲🏢🏢🏢🌲🌲🌲🌲🏔🏔🏔🏔🏔🌲🌲🌲🌲🌲🏡🌲🌾🌴🌴🏖🌊🌊🏖🌴🌴🌴🌴🌴🌴🌴🌴🌴🏖🏖🏖🏖🌴🌴🌴🌴🌴🌴🌴🌴🌴🌴🌴🌴🌴🌴🌴🌴🌴🏢🌲🌲🌲🌲🌲🏔🌲🌲🏡🌲🌲🌾🌾🌲🌲🌲🌲🌲🌲🏔🏔🌲🌲🌲🌲🌲🏢
🌊🌊🌴🌴🌴🌾🏡🌲🏔🏔🌲🌲🌲🌲🌲🏢🌴🌴🌴🏢🏢🌲🌲🌲🌲🌲🌲🌲🌲🏔🏔🌲🌲🌲🏡🌲🌾🌴🌴🌴🌊🌊🏖🌴🌴🌴🏖🏖🏖🏖🏖🏖🏖🏖🏖🏖🏖🏖🏖🏖🏖🏖🏖🏖🏖🌴🌴🌴🌴🌴🌴🌴🌴🏢🌲🌲🌲🌲🏔🌲🌲🏡🌲🌾🌾🌾🌲🏡🌲🌲🌲🌲🏔🏔🌲🌲🌲🌲🌲🏢
🌊🌊🌴🌴🌴🌲🏡🌲🏔🌲🌲🌲🌲🌲🏢🌴🌴🌴🌴🌴🏢🏢🏢🏢🏢🌲🌲🌲🌲🌲🌲🌲🏔🏔🌲🌲🏡🌲🌾🌴🌴🌊🌊🌊🏖🏖🌊🌊🌊🌊🌊🌊🌊🏖🌊🌊🌊🌊🌊🌊🌊🌊🌊🌊🌊🏖🏖🌴🌴🌴🌴🌴🌴🌴🏢🌲🌲🌲🏔🌲🌲🏡🌲🌾🌾🌾🌲🏡🌲🌲🌲🌲🏔🏔🌲🌲🌲🌲🌲🌲
🌊🌊🌴🌴🌾🌲🌲🌲🏔🏔🌲🌲🌲🌲🏢🌴🌴🌴🌴🌴🌴🌴🌴🌴🌴🏢🏢🌲🌲🌲🌲🌲🌲🌲🌲🏔🌲🌲🏡🌾🌴🏖🌊🌊🌊🌊🌊🌊🌊🌊🌊🌊🌊🌊🌊🌊🌊🌊🌊🏖🏖🌊🌊🌊🌊🌊🌊🏖🏖🏖🏖🏖🌴🌴🌴🌲🌲🌲🏔🌲🌲🏡🌲🌾🌾🌾🌾🌲🏡🌲🌲🌲🌲🏔🌲🌲🌲🌲🌲🌲
🌊🌊🌴🌴🌾🌲🌲🌲🏔🏔🏔🌲🌲🌲🏢🌴🌴🌴🌴🌴🌴🌴🌴🌴🌴🏢🏢🏢🌲🏢🏢🏢🏢🌲🌲🌲🌲🏔🌲🏡🌾🌴🏖🌊🌊🌊🌊🏖🌊🌊🌊🌊🌊🌊🌊🏖🏖🌴🌴🌴🌴🏖🏖🌊🌊🌊🌊🌊🌊🌊🌊🏖🏖🌴🌴🏢🌲🌲🌲🏔🌲🌲🏡🌲🌾🌾🌾🌲🌲🏡🌲🌲🌲🏔🌲🌲🌲🌲🌲🌲
🌊🏖🌴🌴🌾🌲🌲🌲🏔🏔🏔🏔🌲🌲🏢🌴🌴🌴🌴🌴🌴🌴🌴🌴🌴🌴🏢🏢🏢🏢🌴🌴🌴🌴🏢🌲🌲🌲🏔🌲🏡🌾🌴🌴🌴🌴🌴🌴🌴🌴🏖🏖🏖🏖🏖🌴🌴🌴🌴🌴🌴🌴🌴🏖🏖🌊🌊🌊🌊🌊🌊🌊🏖🌴🌴🌴🏢🌲🌲🌲🏔🌲🏡🌲🌾🌾🌾🌾🌲🏡🏡🌲🌲🏔🌲🌲🌲🌲🌲🌲
🌊🏖🌴🌾🌲🏡🏡🌲🌲🌲🌲🏔🌲🌲🌲🏢🌴🌴🌴🌴🌴🌴🌴🌴🌴🌴🌴🌴🌴🌴🌴🌴🌴🌴🌴🌴🏢🌲🌲🌲🌲🏡🌾🌴🌴🌴🌴🌴🌴🌴🌴🌴🌴🌴🌴🌴🌴🌴🌾🌾🌴🌴🌴🌴🌴🏖🌊🌊🌊🌊🌊🌊🏖🏖🌴🌴🌴🏢🌲🌲🏔🌲🏡🌲🌾🌾🌾🌾🌾🌲🏡🌲🌲🏔🏔🌲🌲🌲🌲🏢
🌊🌴🌴🌾🌲🏡🏡🌲🌲🌲🌲🌲🏔🌲🌲🏢🌴🌴🌴🌴🌴🌴🌴🌴🌴🌴🌴🌴🌴🌴🌴🌴🌴🌴🌴🌴🌴🌴🌲🌲🏔🌲🏡🌲🌲🌲🌾🌾🌾🌾🌾🌾🌾🌾🌴🌾🌾🌾🌾🌾🌾🌴🌴🌴🌴🌴🏖🏖🌊🌊🌊🌊🌊🏖🌴🌴🌴🌴🏢🌲🌲🌲🌲🌲🌾🌾🌾🌾🌲🌲🏡🌲🌲🏔🏔🌲🌲🌲🌲🏢
🌊🏖🌴🌾🌲🏡🏡🏡🏡🏡🌲🌲🏔🌲🌲🏢🌴🌴🌴🌴🌴🌴🌴🌴🌴🌴🌴🌴🌴🌴🌴🌴🏖🏖🌊🏖🌴🌴🏢🌲🌲🌲🌲🌲🌲🌲🏡🏡🏡🏡🏡🏡🏡🌲🌲🌲🌲🌲🌲🌲🌾🌾🌴🌴🌴🌴🌴🌴🏖🌊🌊🌊🌊🏖🏖🏖🌴🌴🌴🏢🌲🏔🌲🏡🌲🌲🌲🌲🌲🏡🌲🌲🏔🏔🌲🌲🌲🌲🌲🌴
🌊🏖🌴🌾🌲🌲🏡🏡🏡🏡🌲🌲🏔🌲🌲🏢🌴🌴🌴🌴🌴🌴🌴🌴🌴🌴🌴🌴🌴🌴🌴🌴🏖🌊🌊🌊🏖🌴🌴🏢🌲🌲🏔🏔🏔🌲🌲🌲🌲🌲🌲🌲🌲🌲🏡🏡🏡🏡🏡🏡🌲🌲🌾🌾🌾🌾🌴🌴🌴🏖🌊🌊🌊🌊🌊🌊🏖🏖🌴🌴🌲🌲🌲🏡🏡🏡🏡🏡🏡🏡🌲🌲🏔🌲🌲🌲🌲🌲🌲🏢
🌊🌊🌴🌴🌲🌲🌲🌲🌲🏡🌲🌲🌲🌲🌲🏢🌴🌴🌴🌴🌴🏢🏢🏢🌴🌴🌴🌴🌴🌴🏖🏖🌊🌊🌊🌊🌊🌴🌴🏢🌲🌲🌲🌲🌲🌲🌲🌲🏔🏔🏔🏔🏔🏔🌲🌲🌲🌲🌲🌲🏡🏡🏡🏡🌲🌲🌾🌾🌴🌴🌴🏖🌊🌊🌊🌊🌊🌊🌊🌴🌴🌲🏔🌲🌲🌲🏡🏡🏡🌲🌲🏔🌲🌲🌲🌲🌲🌲🌲🏢
🏖🌊🌴🌴🌾🌾🌲🌲🌲🏡🌲🏔🌲🌲🌲🏢🌴🌴🌴🌴🏢🌲🌲🌲🏢🌴🌴🌴🌴🏖🏖🌊🌊🌊🌊🌊🌊🏖🌴🌴🏢🌲🌲🌲🌲🌲🌲🌲🌲🌲🌲🌲🌲🌲🏔🏔🌲🌲🌲🌲🌲🌲🌲🌲🌲🏡🏡🌲🌾🌴🌴🌴🏖🌊🌊🌊🌊🌊🌊🏖🌴🏢🌲🏔🌲🌲🌲🌲🌲🌲🌲🏔🌲🌲🌲🌲🌲🌲🏢🏢
🏖🌊🏖🌴🌴🌾🌾🌲🌲🏡🌲🏔🌲🌲🌲🏢🌴🌴🏢🏢🌲🌲🌲🌲🌲🏢🌴🌴🌴🏖🌊🌊🌊🌊🌊🌊🌊🏖🌴🌴🌴🏢🏢🏢🏢🏢🏢🌲🌲🌲🌲🌲🌲🌲🌲🏔🏔🏔🏔🌲🌲🌲🌲🌲🌲🌲🌲🏡🏡🌲🌾🌴🌴🌴🏖🏖🌊🌊🌊🌊🌴🌴🌲🌲🏔🌲🌲🌲🌲🌲🌲🌲🌲🌲🌲🌲🌲🌲🏢🏢
🏖🌊🌊🌴🌴🌴🌾🌲🏡🏡🌲🌲🌲🌲🌲🏢🏢🏢🏢🌲🌲🌲🌲🌲🌲🏢🏢🌴🌴🏖🌊🌊🌊🌊🌊🌊🌊🌊🏖🌴🌴🌴🌴🌴🌴🌴🌴🏢🌲🌲🌲🌲🌲🌲🌲🏔🏔🏔🏔🌲🌲🌲🌲🏔🏔🏔🏔🌲🌲🏡🌲🌾🌴🌴🌴🌴🏖🌊🌊🌊🏖🌴🏢🌲🌲🌲🏔🌲🌲🌲🏔🌲🌲🌲🏢🏢🏢🏢🏢🏢
🏖🌊🌊🏖🌴🌴🌾🌲🏡🌲🌲🌲🏔🌲🌲🌲🌲🌲🌲🌲🌲🌲🌲🌲🌲🏢🏢🌴🌴🏖🌊🌊🌊🌊🌊🌊🌊🌊🏖🌴🌴🌴🌴🌴🌴🌴🌴🌴🏢🌲🌲🌲🌲🌲🌲🌲🏔🏔🏔🌲🌲🏔🏔🌲🌲🌲🌲🏔🌲🌲🏡🌲🌾🌾🌴🌴🌴🏖🌊🌊🏖🌴🌴🏢🌲🌲🌲🏔🏔🏔🌲🌲🌲🏢🌴🌴🌴🌴🌴🌴
🏖🌊🌊🏖🌴🌴🌴🌲🏡🌲🌲🌲🏔🌲🌲🌲🌲🌲🌲🌲🌲🌲🌲🌲🌲🏢🌴🌴🌴🌴🏖🌊🌊🌊🌊🌊🌊🏖🏖🌴🌴🌴🌴🌴🌴🌴🌴🌴🏢🏢🌲🌲🌲🌲🌲🌲🌲🌲🏔🏔🏔🏔🌲🌲🌲🌲🌲🌲🏔🌲🌲🏡🏡🌲🌲🌾🌴🌴🌊🌊🌊🏖🌴🌴🌴🏢🌲🌲🌲🌲🌲🌲🏢🌴🌴🌴🌴🌴🌴🌴
🏖🌊🌊🌊🌴🌴🌴🌲🏡🌲🌲🌲🏔🌲🌲🌲🌲🌲🌲🌲🌲🌲🌲🌲🌲🏢🌴🌴🌴🌴🏖🌊🌊🌊🌊🌊🌊🏖🏖🌴🌴🌴🌴🌴🌴🌴🌴🌴🌴🏢🏢🌲🌲🌲🌲🌲🌲🌲🌲🌲🌲🌲🌲🌲🏢🏢🏢🌲🌲🏔🌲🌲🌲🌲🏡🌲🌾🌴🌴🌊🌊🌊🌊🏖🌴🌴🌴🏢🌲🌲🏢🌴🌴🌴🏖🏖🏖🏖🏖🏖
🌴🌊🌊🌊🌴🌴🌾🌲🏡🌲🌲🌲🏔🌲🌲🌲🌲🌲🌲🌲🌲🌲🌲🌲🌲🏢🌴🌴🌴🌴🌴🏖🌊🌊🌊🌊🏖🏖🌴🌴🌴🌴🌴🌴🌴🌴🌴🌴🌴🌴🏢🏢🌲🌲🌲🌲🌲🌲🌲🌲🌲🌲🌲🏢🌴🌴🌴🏢🌲🌲🏔🏔🌲🌲🌲🏡🌲🌾🌴🌴🏖🌊🌊🌊🌊🏖🌴🌴🌴🌴🌴🌴🏖🌊🌊🌊🌊🌊🌊🌊
🌴🌊🌊🌊🌴🌴🌾🌲🏡🌲🌲🌲🏔🌲🌲🌲🌲🌲🌲🌲🌲🌲🌲🌲🌲🏢🌴🌴🌴🌴🌴🌴🏖🏖🏖🏖🌴🌴🌴🌴🌴🌴🌴🌴🏢🏢🏢🌴🌴🌴🌴🏢🌲🌲🌲🌲🌲🏢🏢🌲🌲🏢🏢🌴🌴🌴🌴🌴🏢🌲🌲🌲🏔🏔🌲🌲🏡🌲🌾🌴🌴🌴🏖🌊🌊🌊🏖🌴🌴🌴🌴🏖🌊🌊🌊🌊🌊🌊🌊🌊
🌴🌊🌊🏖🌴🌾🌲🌲🏡🏡🌲🌲🏔🌲🌲🌲🌲🌲🌲🌲🌲🌲🌲🌲🌲🏢🏢🏢🏢🏢🌴🌴🌴🌴🌴🌴🌴🌴🌴🌴🌴🌴🌴🏢🏢🏢🏢🌴🌴🌴🌴🏢🌲🌲🌲🌲🏢🏢🏢🏢🏢🏢🌴🌴🌴🏖🏖🌴🌴🌴🏢🌲🌲🌲🏔🌲🌲🌲🏡🏡🌾🌴🌴🌊🌊🌊🏖🏖🏖🏖🌊🌊🌊🌊🌊🌊🌊🌊🌊🌊
🏖🌊🌊🌴🌴🌾🌲🌲🏡🏡🏡🌲🌲🏔🌲🌲🌲🌲🌲🌲🌲🌲🌲🌲🌲🌲🌲🌲🌲🏢🌴🌴🌴🌴🌴🌴🌴🌴🌴🌴🌴🌴🌴🌴🏢🏢🏢🌴🌴🌴🌴🏢🌲🌲🌲🌲🏢🏢🏢🏢🏢🌴🌴🌴🏖🌊🌊🏖🌴🌴🌴🌲🌲🌲🌲🏔🏔🏔🌲🌲🏡🌾🌴🏖🌊🌊🌊🌊🌊🌊🌊🌊🌊🏖🏖🌊🌊🌊🌊🏖
🏖🌊🌊🌴🌴🌲🌲🌲🌲🌲🌲🏡🌲🌲🏔🏔🏔🏔🌲🌲🌲🌲🏔🏔🌲🌲🌲🌲🌲🌲🏢🌴🌴🌴🌴🌴🌴🌴🌴🏖🏖🌴🌴🌴🏢🏢🏢🌴🌴🌴🌴🏢🌲🌲🌲🌲🌲🏢🏢🏢🌴🌴🌴🌴🏖🌊🌊🌊🏖🌴🌴🌴🌲🌲🌲🌲🌲🌲🌲🌲🏡🌾🌴🏖🌊🌊🌊🌊🌊🌊🌊🏖🏖🏖🏖🏖🏖🏖🏖🌴
🌊🌊🌊🌴🌴🌲🌲🌲🌲🌲🌲🏡🌲🌲🌲🌲🌲🌲🌲🏡🏡🌲🌲🌲🌲🌲🏔🏔🌲🌲🏢🌴🌴🌴🌴🌴🌴🌴🌴🏖🏖🌴🌴🌴🌴🏢🌴🌴🌴🌴🌴🏢🌲🌲🌲🌲🏢🏢🏢🏢🏢🌴🌴🌴🏖🌊🌊🌊🌊🏖🌴🌴🌴🏢🏢🌲🌲🌲🌲🏔🌲🌾🌴🌴🌊🌊🌊🌊🌊🏖🌴🌴🌴🌴🌴🌴🌴🌴🌴🌴
🌊🌊🌊🌴🌴🌾🌲🌲🌲🌾🌲🌲🏡🌲🌲🌲🏡🏡🌲🌲🌲🌲🏡🌲🌲🌲🌲🌲🏔🌲🏢🌴🌴🌴🌴🌴🌴🌴🌴🌴🌴🌴🌴🌴🌴🌴🌴🌴🌴🌴🌴🌴🏢🌲🌲🌲🏢🏢🏢🏢🏢🌴🌴🌴🌊🌊🌊🌊🌊🌊🏖🌴🌴🌴🌴🌴🏢🌲🌲🏔🌲🌲🌴🌴🏖🏖🏖🌴🌴🌴🌴🌴🌴🌴🌴🌴🌴🌴🌴🌾
🏖🌊🌊🌴🌴🌾🌲🌲🌲🌲🌲🌲🏡🏡🏡🏡🌲🌾🌾🌴🌴🌾🌲🌲🏡🏡🏡🌲🏔🌲🏢🌴🌴🌴🌴🌴🌴🌴🌴🌴🌴🌴🌴🌴🏢🏢🌴🌴🌴🌴🌴🌴🌴🏢🏢🏢🏢🏢🏢🏢🏢🌴🌴🌴🏖🌊🌊🌊🌊🌊🏖🏖🌴🌴🌴🌴🌴🏢🌲🏔🌲🌲🌾🌴🌴🌴🌴🌴🌾🌲🌲🌲🌲🌾🌾🌴🌴🌾🌾🌲
🏖🌊🌊🌴🌴🌾🌲🌲🌲🌲🌲🌲🏡🏡🏡🌲🌾🌴🌴🌴🌴🌴🌴🌾🌲🌲🏡🌲🏔🌲🏢🌴🌴🌴🌴🌴🌴🌴🌴🌴🌴🌴🌴🏢🏢🏢🏢🌴🌴🌴🌴🌴🌴🌴🏢🏢🏢🏢🌴🏢🏢🌴🌴🌴🏖🌊🌊🌊🌊🌊🌊🏖🏖🌴🌴🌴🌴🏢🌲🌲🌲🏡🌲🌾🌾🌾🌲🌲🏡🏡🌲🌲🏡🏡🌲🌲🌲🌲🏡🏡
🌴🌊🌊🏖🌴🌾🌲🌲🏡🏡🌲🌲🌲🌲🌲🌲🌾🌴🌴🌴🌴🌴🌴🌴🌾🌲🏡🌲🏔🌲🏢🌴🌴🌴🌴🌴🌴🌴🌴🏢🏢🌲🌲🌲🌲🌲🌲🏢🌴🌴🌴🌴🌴🌴🏢🏢🏢🌴🌴🌴🌴🌴🌴🌴🏖🌊🌊🌊🌊🌊🌊🌊🌊🏖🌴🌴🌴🏢🌲🌲🌲🌲🌲🏡🏡🏡🏡🌲🌲🌲🌲🌲🌲🌲🌲🌲🏡🏡🌲🌲
🌴🏖🌊🌊🌴🌴🌲🌲🌲🌲🌲🌲🌲🌾🌾🌾🌴🌴🌴🌴🌴🌴🌴🌴🌲🏡🌲🌲🌲🌲🌲🏢🌴🌴🌴🌴🌴🌴🏢🌲🌲🌲🌲🌲🌲🌲🌲🌲🏢🌴🌴🌴🌴🌴🏢🏢🌴🌴🌴🌴🌴🌴🌴🏖🌊🌊🌊🌊🌊🌊🌊🌊🌊🌊🏖🌴🌴🏢🌲🌲🏔🌲🌲🌲🌲🌲🌲🌲🌲🌲🌲🌲🌲🌲🌲🌲🌲🌲🌲🌲
🌴🌴🌊🌊🏖🌴🌴🌾🌲🌲🌾🌾🌾🌴🌴🌴🌴🌴🌴🌴🌴🌴🌴🌾🌲🌲🌲🏔🌲🌲🌲🌲🏢🌴🌴🌴🌴🏢🌲🌲🌲🌲🌲🌲🌲🌲🌲🌲🌲🏢🏢🏢🏢🏢🏢🏢🌴🌴🌴🌴🌴🌴🏖🌊🌊🌊🌊🌊🏖🏖🌊🌊🌊🌊🏖🌴🌴🏢🌲🌲🏔🌲🌲🌲🌲🌲🌲🌲🌲🏔🏔🏔🏔🏔🏔🏔🏔🏔🏔🌲
🏢🌴🌴🌊🌊🌴🌴🌴🌴🌴🌴🌴🌴🌴🌴🌴🌴🌴🌴🌴🌴🌴🌴🌲🏡🌲🏔🌲🌲🌲🌲🌲🏢🏢🌴🌴🌴🏢🌲🌲🌲🌲🏔🏔🏔🏔🏔🌲🌲🌲🌲🌲🌲🌲🏢🏢🌴🌴🌴🌴🌴🏖🌊🌊🌊🌊🏖🏖🌴🌴🏖🌊🌊🌊🌊🏖🌴🌴🌲🌲🏔🏔🌲🏔🏔🏔🏔🏔🏔🏔🌲🌲🌲🌲🌲🌲🌲🌲🌲🌲
🌲🌴🌴🏖🌊🌊🏖🌴🌴🌴🌴🌴🌴🌴🌴🌴🌴🌴🌴🌴🌴🌴🌾🌲🌲🌲🌲🌲🌲🌲🌲🌲🌲🌲🏢🏢🏢🌲🌲🌲🏔🏔🏔🌲🌲🌲🌲🏔🏔🌲🌲🌲🌲🌲🌲🏢🏢🌴🌴🌴🏖🌊🌊🌊🌊🏖🌴🌴🌴🌴🌴🏖🌊🌊🌊🏖🌴🌴🌲🌲🏔🏔🏔🏔🏔🏔🏔🏔🌲🌲🌲🌲🌲🌲🌲🌲🌲🌲🌲🏢
🌲🏢🌴🌴🌊🌊🌊🏖🌴🌴🌴🌴🌴🌴🌴🌴🌴🌴🌴🌴🌴🌾🌾🏡🌲🏔🌲🌲🌲🌲🌲🌲🌲🌲🌲🌲🌲🌲🌲🌲🏔🌲🌲🌲🌲🌲🌲🌲🌲🌲🏔🌲🌲🌲🌲🌲🏢🌴🌴🌴🏖🌊🌊🌊🏖🌴🌴🌴🌴🌴🌴🌴🏖🌊🌊🌊🏖🌴🏢🌲🌲🌲🌲🌲🌲🌲🌲🌲🌲🌲🌲🌲🌲🌲🌲🌲🌲🌲🏢🌴
🌲🏢🌴🌴🏖🌊🌊🌊🏖🏖🌴🌴🌴🌴🌴🌴🌴🌴🌴🌴🌴🌾🌲🏡🌲🏔🌲🌲🌲🌲🌲🌲🌲🌲🌲🌲🌲🌲🌲🏔🌲🌲🏡🏡🌲🌲🌲🌲🏡🌲🌲🏔🌲🌲🌲🌲🌲🌴🌴🌴🏖🌊🌊🏖🌴🌴🌴🌴🌴🌴🌴🌴🏖🌊🌊🌊🏖🌴🌴🌲🌲🌲🌲🌲🌲🌲🌲🌲🌲🏢🏢🏢🌲🌲🌲🌲🌲🏢🏢🌴
🌲🏢🌴🌴🏖🌊🌊🌊🌊🏖🏖🌴🌴🌴🌴🌴🌴🌴🌴🌴🌾🌾🌾🌲🌲🌲🏔🌲🌲🌲🌲🌲🌲🌲🌲🏔🏔🏔🏔🌲🌲🌲🌲🌾🌾🌾🌾🌾🌲🏡🌲🌲🏔🌲🌲🌲🌲🏢🌴🌴🏖🌊🌊🏖🌴🌴🌴🌴🌴🌴🌴🌴🏖🌊🌊🌊🏖🌴🌴🏢🏢🌲🌲🌲🌲🌲🌲🌲🏢🌴🌴🌴🏢🏢🌲🌲🌲🏢🏢🌴
🌲🌲🌴🌴🏖🌊🌊🌊🌊🌊🏖🏖🏖🌴🌴🌴🌴🌴🌴🌴🌴🌾🌾🌲🏡🌲🏔🌲🌲🌲🌲🌲🌲🌲🏔🏔🌲🌲🌲🌲🌲🏡🌲🌾🌾🌴🌴🌾🌾🌲🌲🌲🏔🌲🌲🌲🌲🌴🌴🌴🏖🌊🌊🏖🌴🌴🌴🌴🌴🌴🌴🏖🌊🌊🌊🌊🌴🌴🌴🌴🏢🏢🏢🌲🌲🌲🏢🏢🌴🌴🌴🌴🌴🌴🌴🏢🏢🏢🏢🏢
🌲🌲🏢🌴🌴🌊🌊🌊🌊🌊🌊🌊🏖🏖🏖🌴🌴🌴🌴🌴🌴🌴🌴🌾🌲🌲🌲🏔🌲🌲🌲🌲🌲🏔🏔🌲🌲🌲🌲🌲🌲🏡🌲🌾🌾🌴🌴🌴🌾🌲🏡🌲🌲🏔🌲🌲🌲🌴🌴🌴🏖🌊🌊🏖🌴🌴🌴🌴🌴🏖🏖🌊🌊🌊🌊🏖🌴🌴🌴🌴🌴🏢🏢🏢🌲🏢🏢🌴🌴🌴🌴🌴🌴🌴🌴🌴🏢🏢🏢🏢
🏔🌲🏢🌴🌴🏖🌊🌊🌊🌊🌊🌊🌊🌊🏖🏖🌴🌴🌴🌴🌴🌴🌴🌾🌲🏡🌲🏔🌲🌲🌲🌲🌲🏔🌲🌲🌲🌲🏡🏡🏡🏡🌲🌾🌾🌾🌾🌾🌾🌲🏡🌲🌲🏔🌲🌲🌲🌴🌴🌴🏖🌊🌊🌊🏖🌴🌴🌴🏖🌊🌊🌊🌊🌊🏖🌴🌴🌴🌴🌴🌴🏢🏢🏢🏢🏢🌴🌴🌴🌴🌴🌴🌴🌴🌴🌴🌴🏢🌲🌲
🏔🌲🏢🌴🌴🏖🏖🌊🌊🌊🌊🌊🌊🌊🌊🏖🌴🌴🌴🌴🌴🌴🌴🌾🌲🏡🌲🏔🏔🌲🌲🌲🏔🏔🌲🌲🏡🏡🏡🏡🏡🌲🌲🌲🌲🌲🌾🌾🌲🌲🏡🌲🌲🏔🌲🌲🌲🏢🌴🌴🌴🌊🌊🌊🏖🏖🏖🏖🌊🌊🌊🌊🌊🏖🌴🌴🌴🌴🌴🌴🌴🏢🏢🏢🏢🏢🌴🌴🌴🌴🌴🌴🌴🌴🌴🌴🌴🏢🌲🌲
🏔🌲🏢🌴🌴🌴🌴🏖🏖🌊🌊🌊🌊🌊🌊🏖🌴🌴🌴🌴🌴🌴🌾🌾🌲🏡🌲🌲🏔🏔🏔🏔🏔🌲🌲🏡🏡🌲🌲🌲🌲🌲🌲🌲🌲🌲🌲🌲🏡🏡🌲🌲🌲🌲🏔🌲🌲🏢🌴🌴🌴🏖🌊🌊🌊🌊🏖🌊🌊🌊🌊🌊🏖🌴🌴🌴🌴🌴🌴🌴🌴🌴🏢🏢🏢🌴🌴🌴🌴🌴🌴🌴🌴🌴🌴🌴🌴🏢🌲🌲
🏔🌲🏢🌴🌴🌴🌴🌴🏖🏖🌊🌊🌊🌊🌊🌴🌴🌴🌴🌴🌾🌾🌾🌲🌲🏡🌲🌲🏔🏔🏔🏔🌲🌲🌲🏡🏡🌲🌲🌲🌲🌲🌲🌲🌲🌲🌲🏡🏡🌲🌲🌲🌲🌲🌲🏔🌲🌲🏢🌴🌴🌴🏖🌊🌊🌊🌊🌊🌊🌊🌊🌊🏖🌴🌴🌴🌴🌴🌴🌴🌴🌴🏢🏢🏢🏢🌴🌴🌴🌴🌴🌴🌴🌴🌴🌴🌴🌴🏢🌲
🏔🌲🏢🌴🌴🌴🌴🌴🏖🌊🌊🌊🌊🌊🏖🌴🌴🌴🌴🌾🌾🌾🌾🌲🌲🏡🌲🌲🌲🏔🏔🌲🌲🌲🏡🏡🏡🌲🌲🌲🌾🌾🌾🌾🌾🌲🌲🏡🏡🌲🌲🌲🌲🌲🌲🏔🌲🌲🌲🏢🌴🌴🌴🌊🌊🌊🌊🌊🌊🌊🌊🏖🌴🌴🌴🌴🌴🌴🌴🌴🌴🌴🏢🏢🌲🏢🏢🌴🌴🌴🏢🏢🏢🌴🌴🌴🌴🌴🏢🏢
🏔🌲🏢🌴🌴🌴🌴🌴🏖🌊🌊🌊🌊🏖🏖🌴🌴🌴🌴🌴🌴🌾🌾🌾🌲🏡🏡🌲🌲🏔🏔🌲🌲🌲🌲🏡🏡🏡🌲🌲🌾🌾🌾🌾🌾🌾🌲🌲🏡🏡🏡🏡🏡🏡🌲🌲🏔🌲🌲🌲🏢🌴🌴🏖🌊🌊🌊🌊🌊🌊🏖🏖🌴🌴🌴🌴🌴🌴🌴🌴🌴🏢🏢🌲🌲🌲🌲🌲🏢🌲🌲🌲🌲🏢🌴🌴🌴🌴🌴🏢
🏔🌲🌲🌴🌴🌴🌴🏖🌊🌊🌊🌊🌊🏖🌴🌴🌴🌴🌴🌴🌴🌴🌾🌾🌲🌲🏡🌲🌲🏔🏔🌲🌲🌲🌲🌲🌲🏡🏡🌲🌲🌾🌾🌴🌴🌾🌾🌲🌲🏡🏡🏡🏡🏡🌲🌲🏔🌲🌲🌲🌲🏢🌴🌴🏖🌊🌊🏖🏖🏖🌴🌴🌴🌴🌴🌴🌴🌴🌴🌴🌴🏢🌲🌲🌲🌲🌲🌲🌲🌲🌲🌲🌲🌲🏢🌴🌴🌴🌴🌴
🌲🌲🌲🏢🌴🌴🌴🏖🌊🌊🌊🌊🏖🌴🌴🌴🌴🌴🌴🌴🌴🌾🌾🌾🌲🏡🏡🌲🌲🏔🏔🏔🌲🌲🌲🌲🌲🏡🏡🌲🌲🌾🌾🌴🌴🌾🌾🌲🌲🏡🏡🏡🏡🏡🌲🌲🌲🏔🌲🌲🌲🌲🏢🌴🌴🏖🏖🌴🌴🌴🌴🌴🌴🌴🌴🌴🌴🌴🌴🌴🏢🏢🌲🌲🌲🌲🌲🌲🌲🌲🌲🌲🌲🌲🏢🏢🌴🌴🌴🏢
🌲🌲🌲🏢🌴🌴🌴🌊🌊🌊🌊🏖🏖🌴🌴🌴🌴🌴🌴🌴🌾🌾🌲🌲🌲🏡🌲🌲🌲🏔🏔🏔🏔🌲🌲🌲🌲🏡🌲🌲🌾🌾🌾🌾🌾🌾🌲🌲🏡🏡🏡🌲🌲🌲🌲🌲🌲🌲🌲🌲🏔🌲🌲🌴🌴🌴🌴🌴🌴🌴🌴🌴🌴🌴🌴🌴🌴🌴🌴🌴🏢🌲🌲🌲🏔🏔🏔🏔🏔🏔🌲🌲🌲🌲🌲🏢🏢🏢🏢🏢
🌲🌲🌲🏢🌴🌴🌴🌊🌊🌊🏖🏖🌴🌴🌴🌴🌴🌴🌴🌾🌾🌲🌲🌲🏡🏡🌲🌲🌲🌲🏔🏔🏔🏔🌲🌲🏡🌲🌲🌾🌾🌾🌾🌾🌾🌾🌲🌲🏡🏡🌲🌲🌲🌲🌲🌲🌲🌲🏡🌲🌲🏔🌲🌲🌴🌴🌴🌴🌴🌴🌴🌴🏢🏢🏢🏢🏢🌴🌴🌴🏢🌲🌲🌲🏔🌲🌲🌲🏔🏔🌲🌲🌲🌲🌲🌲🌲🌲🏢🌲
🌲🌲🌲🌲🏢🌴🏖🌊🌊🏖🌴🌴🌴🌴🌴🌴🌴🌴🌴🌴🌾🌲🌲🌲🏡🏡🌲🌲🌲🌲🌲🏔🏔🏔🌲🌲🏡🌲🌾🌾🌾🌾🌾🌾🌾🌾🌲🌲🏡🏡🏡🌲🌲🌲🌲🌲🏡🏡🌲🏡🌲🌲🌲🌲🌲🏢🏢🏢🏢🏢🌴🏢🌲🌲🌲🌲🏢🌴🌴🌴🏢🌲🌲🏔🌲🌲🌲🌲🌲🏔🏔🌲🌲🌲🌲🌲🌲🌲🌲🌲
🏔🌲🌲🏢🌴🌴🏖🌊🌊🌴🌴🌴🌴🌴🌴🌴🌴🌴🌴🌴🌴🌾🌾🌾🌲🌲🏡🏡🏡🌲🌲🌲🌲🌲🌲🌲🏡🌲🌾🌾🌴🌴🌴🌴🌴🌾🌾🌾🌲🌲🌲🏡🌲🌲🌲🏡🏡🌲🌲🌲🏡🌲🏔🌲🌲🌲🌲🌲🌲🌲🌲🌲🌲🌲🌲🌲🏢🏢🌴🏢🏢🌲🌲🏔🌲🌲🌲🌲🌲🌲🏔🏔🌲🌲🌲🌲🌲🌲🌲🌲
🏔🌲🌲🏢🌴🌴🌊🌊🏖🌴🌴🌴🌴🌴🌴🌴🏖🏖🌴🌴🌴🌴🌴🌴🌾🌾🌲🌲🌲🏡🏡🏡🌲🌲🏡🏡🌲🌾🌾🌴🌴🌴🌴🌴🌴🌴🌴🌴🌴🌾🌾🌾🌲🏡🏡🏡🌲🌲🌲🌲🌲🌲🌲🌲🌲🌲🌲🌲🌲🌲🌲🌲🌲🌲🌲🌲🏢🏢🌴🏢🌲🌲🌲🏔🌲🌲🌲🌲🌲🌲🌲🏔🏔🏔🌲🌲🌲🌲🌲🌲
🌲🌲🏢🌴🌴🏖🌊🌊🌴🌴🌴🌴🌴🌴🌴🏖🏖🏖🏖🏖🌴🌴🌴🌴🌴🌴🌾🌾🌾🌲🌲🌲🏡🌲🌲🌲🌾🌴🌴🌴🌴🌴🏖🏖🏖🌴🌴🌴🌴🌴🌴🌴🌴🌾🌲🌲🌲🌲🌲🌲🏡🌲🌲🏔🌲🌲🌲🌲🌲🌲🌲🌲🌲🌲🌲🌲🌲🏢🌴🏢🏢🌲🌲🏔🌲🌲🌲🌲🌲🌲🌲🌲🏔🏔🌲🌲🌲🌲🌲🌲
🌲🏢🌴🌴🏖🌊🌊🏖🌴🌴🌴🌴🌴🌴🌴🌴🏖🏖🌊🌊🌊🏖🌴🌴🌴🌴🌴🌾🌾🌾🌾🌲🌾🌾🌴🌴🌴🌴🌴🌴🏖🌊🌊🌊🌊🌊🌊🌊🏖🏖🏖🏖🌴🌴🌴🌾🌾🌲🌲🌲🏡🌲🌲🏔🌲🌲🌲🏔🏔🏔🏔🌲🌲🌲🌲🌲🌲🏢🏢🏢🏢🌲🌲🌲🌲🏔🏔🌲🌲🌲🌲🌲🌲🏔🌲🌲🌲🌲🌲🌲
🏢🌴🌴🏖🌊🌊🌊🏖🌴🌴🌴🌴🌴🌴🌴🌴🌴🏖🌊🌊🌊🌊🏖🌴🌴🌴🌴🌾🌾🌾🌾🌾🌴🌴🌴🌴🏖🏖🌊🌊🌊🌊🌊🌊🌊🌊🌊🌊🌊🌊🌊🌊🌊🏖🌴🌴🌴🌾🌾🌲🏡🌲🌲🏔🌲🌲🌲🌲🏔🏔🏔🏔🏔🌲🌲🌲🌲🌲🏢🏢🏢🏢🌲🌲🌲🌲🌲🏔🌲🌲🌲🌲🌲🌲🏔🌲🌲🌲🌲🌲
🏢🌴🌴🏖🌊🌊🌊🏖🌴🌴🌴🌴🌴🌴🌴🌴🌴🌴🏖🌊🌊🌊🌊🌴🌴🌴🌴🌴🌴🌴🌴🌴🌴🌴🏖🌊🌊🌊🌊🌊🌊🌊🌊🌊🌊🌊🌊🌊🌊🌊🌊🌊🌊🌊🏖🌴🌴🌴🌾🌲🏡🌲🌲🏔🌲🌲🌲🌲🌲🏔🏔🏔🏔🌲🌲🌲🌲🌲🏢🏢🏢🏢🏢🌲🌲🌲🌲🏔🌲🌲🏡🏡🌲🌲🏔🌲🌲🌲🌲🌲
🏢🌴🌴🏖🌊🌊🌊🏖🌴🌴🌴🌴🌴🌴🌴🌴🌴🌴🏖🌊🌊🌊🌊🏖🌴🌴🌴🌴🌴🌴🌴🌴🏖🌊🌊🌊🌊🌊🌊🌊🌊🏖🏖🏖🌊🌊🌊🌊🌊🌊🌊🌊🌊🌊🌊🌊🏖🌴🌴🌾🌲🏡🌲🌲🏔🌲🌲🌲🌲🏔🏔🏔🏔🌲🌲🌲🌲🌲🌲🏢🏢🏢🌲🌲🌲🌲🌲🏔🌲🌲🏡🏡🌲🌲🏔🌲🌲🌲🌲🌲
🏢🌴🌴🏖🌊🌊🌊🏖🌴🌴🌴🌾🌾🌴🌴🌴🌴🌴🏖🌊🌊🌊🌊🌊🏖🌴🌴🌴🌴🌴🏖🏖🌊🌊🌊🏖🌴🌴🌴🌴🌴🌴🌴🏖🏖🏖🌊🌊🌊🌊🌊🌊🌊🌊🌊🌊🌊🏖🌴🌴🌾🏡🌲🌲🌲🏔🌲🌲🏔🏔🌲🌲🏔🏔🌲🌲🌲🌲🌲🌲🌲🌲🌲🌲🌲🌲🏔🌲🌲🏡🌲🏡🌲🌲🏔🌲🌲🌲🌲🌲
🌲🌴🌴🏖🌊🌊🌊🏖🌴🌴🌴🌾🌾🌾🌾🌴🌴🌴🏖🌊🌊🌊🌊🌊🌊🏖🏖🏖🏖🏖🌊🌊🌊🌊🌴🌴🌴🌴🌴🌴🌴🌴🌴🌴🌴🏖🏖🏖🏖🏖🏖🏖🏖🏖🏖🌊🌊🌊🏖🌴🌴🌲🏡🌲🌲🏔🏔🏔🏔🏔🌲🌲🏔🏔🌲🌲🌲🌲🌲🌲🌲🌲🌲🌲🌲🏔🌲🌲🏡🏡🌲🏡🌲🌲🏔🌲🌲🌲🌲🌲
🌲🏢🌴🏖🌊🌊🌊🏖🌴🌴🌴🌾🌾🌾🌾🌴🌴🌴🏖🌊🌊🌊🌊🌊🌊🌊🏖🏖🌊🌊🌊🌊🌊🏖🌴🌴🏢🏢🏢🏢🏢🌴🌴🌴🌴🌴🌴🏖🏖🏖🏖🏖🏖🏖🏖🌊🌊🌊🏖🌴🌴🌾🌲🏡🌲🌲🏔🏔🏔🏔🌲🌲🏔🌲🌲🌲🌲🌲🌲🌲🌲🌲🌲🌲🏔🏔🌲🌲🏡🌲🌲🏡🌲🏔🌲🌲🌲🌲🌲🌲
🌲🌴🌴🏖🌊🌊🌊🏖🌴🌴🌴🌾🌾🌾🌾🌴🌴🌴🏖🏖🏖🌊🌊🌊🌊🌊🏖🏖🌊🌊🌊🌊🌊🏖🌴🌴🌲🌲🌲🌲🌲🏢🏢🌴🌴🌴🌴🌴🌴🌴🌴🌴🌴🌴🏖🌊🌊🌊🌴🌴🌴🌾🌲🏡🌲🌲🌲🏔🏔🏔🏔🏔🏔🏔🏔🏔🏔🏔🏔🏔🏔🏔🏔🏔🏔🌲🌲🏡🌲🌲🌲🏡🌲🏔🏔🌲🌲🌲🌲🌲
🌲🌴🌴🏖🌊🌊🌊🏖🌴🌴🌴🌾🌾🌲🌾🌾🌴🌴🌴🌴🌴🏖🏖🏖🏖🏖🏖🏖🌊🌊🌊🌊🌊🏖🌴🏢🌲🌲🌲🌲🌲🌲🌲🌲🏢🏢🏢🌴🌴🌴🌴🌴🌴🌴🌴🌊🌊🌊🌴🌴🌾🌲🏡🌲🌲🌲🌲🏔🏔🏔🏔🏔🏔🏔🏔🌲🌲🌲🌲🌲🌲🌲🌲🌲🌲🌲🏡🌲🌲🌾🌲🏡🌲🌲🏔🏔🌲🌲🌲🌲
🌲🌴🌴🏖🌊🌊🌊🏖🌴🌴🌴🌾🌾🌲🌲🌾🌴🌴🌴🌴🌴🌴🌴🏖🏖🏖🏖🏖🌊🌊🌊🌊🏖🌴🌴🏢🌲🌲🌲🌲🌲🌲🌲🌲🌲🌲🌲🌲🏢🏢🏢🌴🌴🌴🌴🌊🌊🌊🌴🌴🌾🌲🏡🌲🌲🌲🌲🏔🏔🏔🏔🌲🏔🏔🌲🌲🌲🏡🏡🏡🏡🌲🌲🌲🌲🏡🌲🌾🌾🌴🌾🌲🏡🌲🌲🌲🏔🏔🌲🌲
🌲🌴🌴🌴🌊🌊🌊🏖🌴🌴🌴🌾🌲🌲🌲🌲🌾🌴🌴🌴🌴🌴🌴🏖🏖🏖🏖🌊🌊🌊🌊🏖🌴🌴🌴🏢🌲🌲🌲🌲🌲🌲🌲🌲🌲🌲🌲🌲🌲🌲🏢🏢🌴🌴🌴🌊🌊🌊🌴🌴🌲🏡🌲🌲🌲🌲🌲🏔🏔🏔🏔🌲🏔🏔🌲🌲🏡🌲🌾🌾🌲🌲🌲🌲🌲🌲🌾🌴🌴🌴🌴🌾🌲🏡🏡🌲🌲🌲🏔🌲
🌲🏢🌴🌴🏖🌊🌊🏖🌴🌴🌴🌾🌲🌲🏡🌲🌾🌴🌴🌴🌴🌴🌴🏖🏖🏖🏖🌊🌊🌊🏖🌴🌴🌴🌴🏢🌲🌲🌲🌲🌲🏔🏔🏔🏔🏔🌲🌲🌲🌲🏢🏢🌴🌴🏖🌊🌊🌊🌴🌴🌲🏡🌲🌲🌲🌲🌲🏔🏔🏔🏔🏔🏔🌲🌲🏡🌲🌾🌴🌴🌴🌴🌴🌴🌾🌴🌴🌴🌴🌴🌴🌴🌴🌾🌲🌲🏡🌲🌲🌲
🌲🏢🌴🌴🏖🌊🌊🏖🌴🌴🌴🌾🌲🌲🏡🌲🌾🌴🌴🌴🌴🌴🌴🏖🌊🌊🌊🌊🌊🏖🌴🌴🌴🌴🌴🏢🌲🌲🌲🌲🌲🏔🌲🌲🌲🏔🏔🌲🌲🌲🏢🌴🌴🌴🌊🌊🌊🏖🌴🌴🌲🏡🌲🌲🌲🌲🌲🏔🏔🏔🏔🏔🏔🌲🏡🏡🌲🌴🌴🌴🌴🌴🌴🌴🌴🌴🌴🌴🏖🏖🏖🌴🌴🌴🌾🌾🌲🏡🌲🌲
🌲🌲🌴🌴🏖🌊🌊🏖🌴🌴🌴🌾🌾🌲🏡🌲🌾🌴🌴🌴🌴🌴🏖🌊🌊🌊🌊🌊🌊🏖🌴🌴🌴🌴🏢🏢🌲🌲🌲🌲🌲🏔🌲🌲🌲🏔🏔🌲🌲🏢🌴🌴🏖🌊🌊🌊🌊🌴🌴🌾🌲🏡🌲🌲🌲🌲🌲🌲🏔🏔🏔🏔🌲🌲🏡🌲🌾🌴🌴🌴🏖🌊🌊🌊🏖🏖🏖🏖🌊🌊🌊🏖🌴🌴🌴🌾🌾🌲🌲🏡
🌲🌲🏢🌴🌴🏖🌊🌊🏖🌴🌴🌴🌾🌲🌲🌲🌾🌴🌴🌴🌴🏖🌊🌊🌊🌊🌊🌊🌊🏖🌴🌴🌴🏢🏢🌲🌲🌲🌲🌲🌲🌲🏔🏔🏔🌲🌲🌲🏢🌴🌴🏖🌊🌊🌊🏖🏖🌴🌴🌾🌲🏡🏡🏡🏡🌲🌲🌲🌲🏔🌲🌲🌲🏡🌲🌾🌾🌴🌴🏖🌊🌊🌊🌊🌊🌊🌊🌊🌊🌊🌊🌊🏖🌴🌴🌴🌾🌾🌾🌲
🏔🌲🌲🏢🌴🌴🏖🌊🌊🏖🌴🌴🌴🌾🌾🌾🌾🌴🌴🌴🏖🌊🌊🌊🌊🌊🌊🌊🏖🌴🌴🌴🌴🌴🏢🌲🌲🌲🌲🌲🌲🌲🌲🌲🌲🌲🌲🏢🌴🌴🏖🌊🌊🌊🏖🏖🌴🌴🌴🌾🌾🌲🌲🌲🌲🌲🏡🌲🌲🌲🌲🌲🏡🌲🌾🌾🌴🌴🌴🏖🌊🌊🌊🌊🌊🌊🌊🌊🌊🌊🌊🌊🌊🌊🌴🌴🌴🌴🌴🌴
🌲🏔🌲🌲🏢🌴🌴🌊🌊🌊🌊🌴🌴🌴🌾🌾🌴🌴🌴🌴🏖🌊🌊🌊🌊🌊🌊🌊🏖🌴🌴🌴🌴🌴🏢🌲🌲🌲🌲🌲🌲🌲🌲🌲🌲🌲🏢🌴🌴🏖🌊🌊🌊🏖🏖🌴🌴🌴🌴🌴🌾🌾🌾🌾🌾🌾🌲🏡🌲🌲🌲🏡🌲🌾🌴🌴🌴🌴🌴🏖🌊🌊🌊🌊🌊🌊🌊🌊🌊🌊🌊🌊🌊🌊🌊🏖🏖🌴🌴🌴
🌲🌲🏔🌲🌲🏢🌴🌴🌊🌊🌊🏖🌴🌴🌴🌴🌴🌴🌴🌴🏖🌊🌊🌊🌊🏖🏖🏖🌴🌴🌴🌴🌴🌴🏢🌲🌲🌲🌲🌲🌲🌲🌲🌲🏢🌴🌴🌴🌴🌊🌊🌊🏖🏖🌴🌴🌴🌴🌴🌴🌴🌴🌴🌴🌴🌴🌾🌲🌲🏡🌲🌲🌾🌾🌴🌴🌴🌴🏖🌊🌊🌊🌊🌊🌊🌊🏖🏖🏖🏖🌴🌴🏖🌊🌊🌊🌊🌊🌊🏖
🏡🌲🌲🏔🌲🌲🏢🌴🌴🌊🌊🌊🏖🌴🌴🌴🌴🌴🌴🌴🏖🌊🌊🌊🏖🌴🌴🌴🌴🌴🌴🌴🌴🌴🌴🏢🌲🌲🌲🌲🌲🏢🏢🏢🌴🌴🌴🌴🏖🌊🌊🏖🌴🌴🌴🌴🌴🌴🌴🌴🌴🌴🌴🌴🌴🌴🌴🌴🌾🌾🌾🌾🌾🌴🌴🌴🌴🏖🌊🌊🌊🌊🌊🌊🌊🏖🌴🌴🌴🌴🌴🌴🌴🌴🏖🏖🌊🌊🌊🌊
🏡🌲🌲🌲🏔🌲🌲🌴🌴🏖🌊🌊🌊🏖🌴🌴🌴🌴🌴🏖🌊🌊🌊🏖🌴🌴🌴🌴🌴🌴🌴🌴🌴🌴🌴🏢🌲🌲🌲🌲🏢🏢🌴🌴🌴🌴🌴🏖🌊🌊🌊🏖🌴🌴🌴🌴🌴🌴🌴🌴🌴🌴🌴🌴🌴🌴🌴🌴🌴🌴🌴🌾🌾🌴🌴🌴🌴🌊🌊🌊🌊🌊🏖🏖🏖🌴🌴🌴🌴🌴🌴🏢🌴🌴🌴🌴🌴🏖🌊🌊
🏡🌲🌲🌲🏔🌲🌲🌴🌴🏖🌊🌊🌊🌊🏖🏖🏖🏖🏖🌊🌊🌊🌊🏖🌴🌴🌴🌴🌴🌴🌴🌴🌴🌴🌴🌴🏢🏢🌲🌲🏢🌴🌴🌴🌴🌴🌴🏖🌊🌊🏖🌴🌴🌴🌴🌴🌴🌴🌴🌴🌴🌴🌴🌴🌴🌴🌴🌴🌴🌴🌴🌴🌾🌴🌴🌴🏖🌊🌊🏖🏖🌴🌴🌴🌴🌴🌴🌴🏢🏢🌲🌲🌲🏢🏢🏢🌴🌴🏖🌊
🏡🌲🌲🌲🏔🌲🌲🌴🌴🌴🌊🌊🌊🌊🌊🌊🌊🌊🌊🌊🌊🌊🌊🏖🏖🌴🌴🌴🌴🌴🌴🌴🌴🌴🌴🌴🌴🌴🏢🏢🌴🌴🌴🌴🌴🌴🌴🏖🌊🌊🏖🌴🌴🌴🌴🌴🌴🌴🌴🌴🌴🌴🌴🌴🌴🏖🏖🏖🌴🌴🌴🌴🌴🌴🌴🏖🌊🌊🏖🌴🌴🌴🌴🌴🌴🌴🌴🏢🌲🌲🌲🌲🌲🌲🌲🌲🏢🌴🌴🌴
🏡🌲🌲🌲🏔🌲🌲🏢🌴🌴🏖🏖🌊🌊🌊🌊🌊🌊🌊🌊🌊🌊🌊🏖🏖🏖🌴🌴🌴🌴🌴🌴🌴🌴🌴🌴🌴🌴🌴🌴🌴🌴🌴🌴🌴🌴🏖🏖🌊🌊🏖🌴🌴🌴🌴🌴🌴🌴🌴🌴🌴🌴🌴🌴🏖🏖🌊🏖🌴🌴🌴🌴🌴🌴🏖🌊🌊🌊🏖🌴🌴🌴🌴🌴🌴🌴🌲🌲🌲🌲🌲🌲🌲🌲🌲🌲🌲🌲🏢🌴
🏡🏡🌲🌲🏔🌲🌲🏢🌴🌴🌴🌴🏖🏖🌊🌊🌊🌊🌊🌊🌊🌊🌊🌊🌊🌊🏖🌴🌴🌴🌴🌴🌴🌴🏖🏖🌴🌴🌴🌴🌴🌴🌴🌴🌴🏖🏖🌊🌊🌊🏖🌴🌴🌴🌴🌴🌴🌴🌴🌴🌴🌴🏖🏖🌊🌊🌊🌊🏖🌴🌴🌴🌴🏖🌊🌊🌊🏖🌴🌴🌴🌴🌴🌴🏢🌲🌲🌲🏔🌲🌲🌲🏔🏔🌲🌲🌲🌲🌲🏢
🌲🏡🏡🌲🏔🌲🌲🏢🌴🌴🌴🌴🌴🌴🏖🏖🌊🌊🌊🌊🌊🌊🌊🌊🌊🌊🌊🏖🌴🌴🌴🌴🌴🏖🏖🏖🏖🏖🌴🌴🌴🏖🏖🏖🏖🏖🏖🌊🌊🌊🏖🌴🌴🌴🌴🌴🌴🌴🌴🌴🌴🌴🏖🌊🌊🌊🌊🌊🏖🏖🏖🏖🏖🌊🌊🌊🏖🌴🌴🌴🌴🌴🌴🏢🌲🌲🏔🌲🌲🌲🌲🌲🌲🌲🏔🏔🌲🌲🌲🌲
🌾🌲🏡🌲🏔🌲🌲🌴🌴🌴🌴🌴🌴🌴🌴🏖🏖🌊🌊🌊🌊🌊🌊🌊🌊🌊🌊🏖🌴🌴🌴🌴🌴🏖🏖🌊🏖🏖🏖🌴🌴🏖🏖🏖🏖🌊🌊🌊🌊🌊🏖🌴🌴🌴🌴🌴🌴🌴🌴🌴🌴🏖🌊🌊🌊🌊🌊🏖🏖🏖🏖🌊🌊🌊🌊🌊🏖🌴🌴🌴🌴🏢🌲🌲🌲🏔🌲🌲🌲🏡🏡🏡🌲🌲🌲🏔🏔🏔🏔🌲
🌾🌲🏡🌲🏔🌲🌲🌴🌴🌴🌴🌴🌴🌴🌴🌴🏖🏖🌊🌊🌊🌊🌊🌊🌊🌊🌊🌊🏖🌴🌴🌴🌴🏖🏖🌊🏖🏖🌴🌴🌴🌴🏖🏖🌊🌊🌊🌊🌊🌊🏖🌴🌴🌴🌴🌴🌴🌾🌾🌴🌴🏖🏖🌊🌊🌊🌊🌊🌊🌊🌊🌊🌊🌊🌊🏖🏖🌴🌴🌴🌴🏢🌲🏔🌲🌲🏡🏡🏡🏡🏡🏡🏡🏡🌲🌲🌲🌲🏔🏔
🌲🌲🏡🌲🏔🌲🌲🌴🌴🌴🌴🌴🌴🌴🏖🏖🏖🏖🌊🌊🌊🌊🌊🌊🌊🌊🌊🏖🏖🌴🌴🌴🌴🏖🏖🏖🏖🌴🌴🌴🌴🌴🌴🏖🏖🌊🌊🌊🌊🌊🌊🏖🌴🌴🌴🌴🌴🌾🌾🌴🌴🌴🏖🏖🏖🏖🌊🌊🌊🌊🌊🌊🌊🏖🏖🏖🌴🌴🌴🌴🏢🌲🌲🌲🌲🏡🏡🌲🏡🌲🌲🌲🌲🌲🏡🌲🌲🌲🌲🏔
🌲🏡🌲🌲🏔🌲🌲🌴🌴🌴🌴🌴🏖🏖🏖🏖🏖🏖🏖🌊🌊🌊🏖🏖🏖🏖🏖🏖🏖🌴🌴🌴🌴🏖🏖🏖🏖🌴🌴🌴🌴🌴🌴🌴🌴🏖🌊🌊🌊🌊🌊🏖🏖🌴🌴🌴🌴🌴🌴🌴🌴🌴🌴🌴🏖🏖🌊🌊🌊🌊🌊🏖🏖🌴🌴🌴🌴🌴🌴🌴🏢🌲🌲🌲🏡🌲🌲🌲🌲🌲🌲🌾🌾🌾🌲🏡🏡🌲🌲🌲
🏡🏡🌲🌲🏔🌲🌲🌴🌴🌴🏖🏖🏖🌊🏖🏖🏖🏖🏖🏖🌊🏖🏖🌴🌴🏖🏖🏖🌴🌴🌴🌴🌴🏖🏖🏖🏖🌴🌴🌴🌴🌴🌴🌴🌴🏖🏖🌊🌊🌊🌊🌊🏖🏖🌴🌴🌴🌴🌴🌴🌴🌴🌴🌴🌴🏖🌊🌊🌊🌊🏖🌴🌴🌴🌴🌴🌴🌴🌴🌴🏢🌲🌲🌲🌲🏡🌲🌲🏡🌲🌲🌾🌴🌴🌾🌲🌲🏡🌲🌲
🏡🏡🌲🌲🏔🌲🌲🌴🌴🌴🏖🌊🌊🌊🌊🌊🏖🏖🏖🏖🏖🏖🌴🌴🌴🌴🏖🌴🌴🌴🌴🌴🌴🏖🏖🌊🏖🏖🌴🌴🌴🌴🌴🌴🌴🌴🏖🏖🌊🌊🌊🌊🌊🏖🏖🌴🌴🌴🌴🌴🌴🌴🌴🌴🌴🏖🌊🌊🌊🌴🌴🌴🌴🌴🌴🏢🏢🏢🌴🌴🏢🌲🌲🏔🌲🏡🏡🏡🏡🏡🌲🌾🌴🌴🌴🌾🌲🌲🏡🌲
🏡🏡🌲🌲🏔🌲🌲🏢🌴🌴🏖🌊🌊🌊🌊🌊🏖🏖🏖🏖🏖🏖🌴🌴🌴🌴🌴🌴🌴🌴🌴🌴🌴🏖🏖🌊🌊🏖🏖🌴🌴🌴🌴🌴🌴🌴🌴🏖🏖🌊🌊🌊🌊🏖🏖🌴🌴🌴🌴🌴🌴🌴🌴🌴🌴🏖🌊🌊🏖🌴🌴🌴🌴🏢🏢🌲🌲🌲🏢🏢🏢🏢🌲🌲🌲🌲🏡🏡🏡🏡🏡🌾🌴🌴🌴🌾🌾🌲🏡🌲
🌲🏡🌲🌲🏔🌲🌲🏢🌴🌴🏖🌊🌊🌊🌊🌊🏖🏖🏖🏖🏖🌴🌴🌴🌴🌴🌴🌴🌴🌴🌴🌴🌴🏖🏖🌊🌊🌊🌊🏖🏖🏖🌴🌴🌴🌴🏖🏖🌊🌊🌊🌊🏖🏖🏖🌴🌴🌴🌴🌴🌴🌴🌴🌴🌴🏖🌊🌊🌴🌴🌴🌴🏢🏢🏢🌲🌲🌲🌲🌲🏢🌲🌲🌲🏔🌲🌲🌲🌲🌲🏡🌲🌾🌾🌾🌾🌾🌲🏡🌲
🌲🏡🌲🏔🌲🌲🌲🏢🌴🌴🌴🏖🏖🏖🏖🏖🏖🏖🌴🌴🌴🌴🌴🌴🌴🌴🌴🌴🌴🌴🌴🌴🏖🏖🌊🌊🌊🌊🌊🌊🌊🌊🌊🏖🏖🏖🏖🏖🌊🌊🌊🏖🏖🌴🌴🌴🌴🌴🌴🌴🌴🌴🌴🌴🌴🌊🌊🌊🌴🌴🌴🌴🏢🏢🌲🌲🌲🌲🌲🌲🌲🌲🌲🌲🏔🌲🌲🌲🌲🌲🌲🌲🏡🌲🌲🌲🌲🏡🌲🌲
🏡🌲🌲🌲🌲🌲🏢🏢🌴🌴🌴🌴🌴🌴🌴🌴🌴🌴🌴🌴🌴🌴🌴🌴🌴🌴🌴🌴🌴🌴🌴🏖🌊🌊🌊🌊🌊🌊🌊🌊🌊🌊🌊🌊🌊🏖🏖🏖🌊🌊🌊🏖🌴🌴🌴🌴🌴🌴🌴🌴🌴🌴🌴🌴🏖🌊🌊🌊🏖🌴🌴🌴🌴🏢🌲🌲🌲🌲🌲🌲🌲🌲🌲🌲🏔🌲🌲🌲🌲🏔🌲🌲🌲🌲🌲🌲🌲🌲🌲🏔
🌲🌲🏔🌲🌲🏢🌴🌴🌴🌴🌴🌴🌴🌴🌴🌴🌴🌴🌴🌴🌴🌴🌴🌴🌴🌴🌴🌴🌴🌴🏖🌊🌊🌊🌊🌊🌊🌊🌊🌊🌊🌊🌊🌊🌊🌊🌊🌊🌊🌊🌊🏖🌴🌴🌴🌴🌴🌴🌴🌴🌴🌴🏖🏖🌊🌊🌊🌊🏖🌴🌴🌴🌴🏢🌲🌲🌲🏔🏔🏔🏔🌲🏔🏔🏔🌲🌲🌲🏔🏔🏔🏔🌲🌲🌲🌲🌲🌲🌲🏔
🌲🏔🌲🌲🏢🌴🌴🌴🌴🌴🌴🌴🌴🌴🌴🌴🌴🌴🌴🌴🌴🌴🌴🌴🌴🌴🌴🌴🌴🌊🌊🌊🌊🌊🌊🌊🌊🌊🌊🌊🌊🌊🌊🌊🌊🌊🌊🌊🌊🌊🏖🏖🌴🌴🌴🌴🌴🌴🌴🌴🌴🌴🏖🌊🌊🌊🌊🌊🏖🌴🌴🌴🌴🏢🌲🌲🌲🏔🌲🌲🏔🏔🏔🌲🌲🌲🌲🌲🏔🏔🏔🏔🏔🏔🌲🌲🏔🏔🏔🌲
🏔🌲🌲🏢🌴🌴🌴🌴🌴🌴🏢🏢🏢🏢🏢🏢🏢🌴🌴🌴🌴🌴🌴🌴🏖🌴🌴🏖🌊🌊🌊🌊🌊🌊🌊🌊🌊🌊🌊🌊🌊🌊🌊🌊🌊🌊🌊🌊🌊🌊🌊🏖🌴🌴🌴🌴🌴🌴🌴🌴🌴🏖🌊🌊🌊🌊🌊🏖🌴🌴🌴🌴🌴🏢🌲🌲🏔🌲🌲🌲🌲🌲🌲🌲🌲🌲🌲🌲🌲🏔🏔🌲🌲🌲🌲🌲🌲🌲🌲🌲
🌲🌲🏢🏢🌴🌴🌴🌴🌴🌴🏢🏢🏢🏢🏢🏢🏢🌴🌴🌴🌴🌴🏖🌊🌊🌊🏖🌊🌊🌊🌊🏖🏖🏖🌊🌊🌊🌊🌊🌊🌊🌊🌊🌊🌊🌊🌊🌊🌊🌊🌊🏖🏖🏖🏖🌴🌴🌴🌴🌴🌴🏖🌊🌊🌊🌊🏖🏖🌴🌴🌴🌴🌴🏢🌲🌲🏔🏔🌲🌲🌲🌲🌲🌲🌲🌲🌲🌲🌲🌲🏔🏔🌲🌲🌲🌲🌲🌲🌲🌲
🌲🌲🏢🏢🌴🌴🌴🌴🌴🌴🌴🏢🏢🏢🌴🌴🌴🌴🌴🌴🏖🌊🌊🌊🌊🌊🌊🌊🌊🌊🏖🏖🏖🏖🌊🌊🌊🌊🌊🌊🏖🏖🌊🌊🌊🌊🌊🌊🌊🌊🌊🌊🏖🏖🏖🌴🌴🌴🌴🌴🌴🌴🏖🌊🌊🌊🏖🌴🌴🌴🌴🌴🌴🏢🌲🌲🌲🏔🏔🏔🏔🌲🌲🌲🏡🏡🏡🌲🌲🌲🌲🌲🏔🏔🌲🌲🌲🌲🌲🌲
🌲🌲🌲🏢🌴🌴🌴🌴🌴🌴🌴🌴🌴🌴🌴🌴🌴🌴🌴🏖🌊🌊🌊🌊🌊🌊🌊🌊🌊🏖🏖🏖🏖🏖🌊🌊🌊🏖🏖🏖🌴🌴🏖🌊🌊🌊🌊🌊🌊🌊🌊🏖🏖🏖🏖🌴🌴🌴🌴🌴🌴🌴🏖🌊🌊🌊🏖🌴🌴🌴🌴🌴🌴🌴🏢🌲🌲🌲🌲🌲🏔🏔🌲🌲🏡🏡🏡🏡🌲🌲🌲🌲🌲🌲🏔🌲🌲🌲🌲🌲
